ur,ur,cr,ur,cb,ub,ur,cb,cb,cb,cg,ur,cg,ur,ur,ur,ur,ur,ub,cb,cb,ur,cb
ur,ur,ur,ur,ur,cr,cr,ur,ur,ur,ub,ur,ur,ur,ur,ur,ur,ur,ub,ub,ur,ur,ur
ur,ur,ur,ur,ug,cg,ur,ur,ur,ur,ub,ur,ur,ur,ur,ur,ur,ur,ub,ub,ub,ub,ur
ur,ur,ur,ur,ur,ur,ur,ur,ur,ur,ur,ur,ur,ur,ug,ug,ug,ug,ug,ub,ub,ub,ub
ur,ug,cg,ur,ur,ur,ug,ug,ug,ur,ur,ur,ub,ub,ub,ub,ur,ub,ug,ub,ub,ub,ub
ur,ug,cr,ur,cr,ur,ur,ur,ub,ur,ug,ug,ub,ug,ub,ub,ub,ub,ug,ub,ub,ux,ub
ur,ug,ug,ug,ug,ur,ur,ur,ur,ur,ur,ur,ub,ub,ub,cb,ub,ub,ub,ub,ub,ub,ur
ur,ur,ur,ur,ug,ur,ur,ur,ur,ur,ur,ur,ub,ub,ub,ur,ub,ub,ub,ub,ub,ub,ur
ur,ur,ur,ur,ug,ug,ug,ug,ur,ur,ur,ur,ur,ur,ur,cr,ur,ur,ug,ug,ug,ur,ur
ur,ub,cb,ur,ur,cg,ug,ug,ur,ur,cr,ug,ub,ux,ux,ux,ux,ub,ug,ub,ug,ub,ur
ux,ub,ux,ub,ub,ub,ux,ur,ub,ux,ux,ug,ub,ux,ux,ub,ub,cb,ub,ub,ug,ub,ur
cg,ub,ug,ub,ub,ub,ug,ur,ub,ug,ug,ug,ug,ug,ug,ub,ub,ub,ub,ub,ug,ur,ur
ux,ub,ub,ub,ub,ub,ug,ur,ub,ug,ug,ux,ub,ug,ug,ug,ug,ug,ub,ub,ub,ub,ub
ux,ux,ub,ub,ub,ub,ug,ur,ug,ug,ug,ux,ug,ug,ug,ux,ub,cg,ub,ub,ub,ub,ub
ux,ux,ub,ub,ug,ug,ug,ur,ug,ug,ug,ug,ug,ux,ug,ug,ub,ub,ub,ub,ub,ub,ub
ux,ur,ur,ur,ur,ug,ug,ug,ug,ux,ux,ux,ub,ux,ux,ux,ub,ug,ug,ub,ub,ub,ub
ux,ur,ux,ug,cr,ux,ux,ur,ub,ux,ux,ux,ub,ub,ub,ub,ub,ux,ux,ux,ur,ux,ux
ux,ur,ux,ux,ux,ux,ux,ur,ub,ux,ux,ux,ux,ux,ux,ux,ub,ux,ux,ux,ur,ux,ux
ux,ur,ux,ux,ux,ux,ux,ur,ub,ux,ux,ux,ux,ux,ux,ux,ub,ux,ux,ux,ur,ur,cb
cg,ur,ux,ux,ux,ux,ux,ur,ub,ux,ux,ux,ux,ux,ux,ux,ub,ur,ur,ur,ur,ur,ur
cb,ur,ux,ux,ub,ub,ub,ur,ub,ub,ub,ub,ub,ub,ub,ub,ub,ux,ux,ux,ur,ur,ur
ub,ub,ub,cb,ur,ur,ur,ur,cb,ux,ux,ux,cg,ux,ux,ux,ur,ur,ur,ur,ur,cr,ur
ub,ub,ub,ub,ub,ux,cr,ux,cr,ux,cb,cg,cb,ux,ux,ux,cr,ux,ux,cr,ur,cr,cb