ug,ug,cr,ug,ug,ug,ur,cb,cb,cb,cb,cg,cg,ub,ug,ug,ug,ug,ug,ug,cb,cb,cb
ug,ug,ur,ug,ug,ug,ur,ug,ug,ug,ub,cg,ub,ub,ub,ub,ub,ub,ub,ub,ub,ub,cg
ug,ug,ur,ug,ug,ug,ur,ug,ug,ug,ug,ug,ug,ug,ug,ub,ug,ug,ug,ug,ug,ub,ug
ug,ug,ur,ug,ug,ug,ur,ug,ug,ug,ug,ug,ug,ug,ug,ug,ug,ur,ur,ur,cr,ub,ub
ur,ur,ur,ur,ur,ur,ur,ur,ub,ub,ug,ug,ug,ug,ug,ug,ug,ur,ug,ug,ug,ub,ug
ug,ug,ur,ug,ug,ug,ug,ug,ug,ug,ug,ug,ug,ug,ug,ug,ug,ur,ug,ug,ug,ub,ug
cg,ur,ur,ug,ug,ug,ur,ug,ub,ub,ur,ur,ur,ur,ur,ur,ur,ur,ug,ug,ug,ug,ug
ub,cr,ur,ur,ug,ug,ur,ub,ub,ub,ub,ur,ur,ug,ur,ug,ug,ug,ug,ug,ug,ug,ug
ub,ur,ur,ur,ug,ug,ur,ug,ug,ub,ug,ug,ug,ug,ur,ur,ur,ur,ur,ur,ur,ur,ur
ub,ur,ur,ur,ug,ug,ur,ug,cb,ub,ug,ug,ug,ug,ur,ug,ub,ub,ug,ur,ug,ur,ur
ub,ur,ur,ur,ug,ur,ur,ur,ug,ug,ug,ur,ur,ug,ur,ug,ub,ub,ub,ug,ug,ur,ur
ub,ur,ur,ug,ug,ur,ur,ur,ug,ur,ug,ur,ug,ug,ur,ug,ub,ub,ub,ug,ug,cr,ur
ub,ur,ur,ur,ur,ur,ur,ur,ug,ur,ug,ur,ug,ug,ur,ug,ug,ub,ug,ug,ub,ug,ur
ub,ur,ur,ur,ug,ur,ur,ug,ug,ug,ug,ur,ur,ur,ur,ur,ur,ur,ug,ub,ub,ur,ur
ub,ur,ur,ur,ug,ur,ur,ub,ug,ur,ug,ur,ur,ug,ur,ug,ug,ub,ug,ub,ub,cb,ur
ub,cg,ur,ur,ub,ur,ur,ub,ug,ub,ug,ug,ur,ug,ur,ug,ug,ub,ug,ub,ub,ub,ub
ub,ug,ur,ur,ur,ur,ur,ur,ug,ur,ub,ug,ur,ur,ur,ur,ur,cg,ug,ur,ur,ur,ur
ub,ug,ug,ug,ug,ug,ur,ur,ug,ug,ug,ug,ur,ur,ur,ur,ur,ur,ur,ur,ub,ub,ub
ub,ug,ug,ug,ug,ur,cr,ug,ug,ug,ub,ug,ur,ur,ug,ug,ub,ub,ub,ub,ub,ub,cb
cb,ug,ug,ur,ur,ur,ur,ur,ug,ur,ub,ur,ur,ur,ug,ug,ur,ub,ub,ub,ub,ub,ub
cb,ur,ug,ug,ug,ug,ur,ur,ug,ug,ur,ur,ur,ur,ur,ur,ur,ur,ub,ub,ub,cb,ub
ur,ur,ur,ug,ur,ug,ur,ur,ug,ug,ur,ur,cg,ur,ur,ur,ur,ur,ur,ub,ub,cr,cb
cb,ug,ug,ug,ug,ug,ur,ug,cg,ug,ur,cg,cb,ur,ur,ur,ur,cb,ug,cr,ur,cr,cb