ur,ur,cr,ur,ur,ur,ur,cb,cb,cb,cg,cg,cg,cb,ux,ux,ux,ux,ux,ur,cb,cb,cb
ur,ur,ur,ur,ur,ur,ur,cg,ux,ur,ur,ux,ux,ux,ux,ux,ux,ux,ur,ur,ur,ur,ur
ur,cr,ur,ur,ur,ur,ur,ur,ur,ur,ur,cg,ur,ur,ur,ur,ur,ur,ur,ur,ur,ur,ur
cb,ur,ur,ur,ur,ur,ur,ur,ur,ur,ur,ug,ug,cr,ur,ug,ur,ur,ur,ur,ur,ur,ur
ur,ur,ur,ur,ur,ur,ur,ur,ur,ur,ur,cr,ur,ur,ur,ur,ur,ur,ur,ur,ur,ur,ur
ur,ur,ur,ur,ur,ur,ur,ur,ur,ur,ur,ur,ur,ur,cr,ug,cr,ug,ur,ur,ur,ur,ur
ur,ur,ur,ur,ur,ur,ur,ur,ur,ur,ur,ur,ur,ur,cr,ug,ur,ur,ur,ur,ur,ur,ur
ur,ur,ur,ur,ur,ur,ur,ur,ur,ur,ur,ur,ug,ug,ur,ur,ug,ug,ug,ur,ur,ur,ur
ur,ur,ur,ur,ur,ur,ur,ur,ur,ur,ur,ur,ug,ub,ur,ur,ug,ug,ug,ur,ur,ur,ur
ur,ur,ur,ur,ur,ur,ur,ur,ur,ub,ub,ub,ub,ub,ur,cg,ug,ug,cg,ug,ur,ur,ur
ur,ur,ur,ur,ur,ur,ur,ur,ur,ub,ur,ug,ug,ug,ug,ub,ub,ub,ub,ug,ur,ur,ug
ur,ux,ug,ug,ub,ur,ur,ur,ug,ub,ug,ur,ug,ub,ub,ub,ub,ub,ur,ur,ub,ur,ur
ur,ux,ug,ug,ug,cg,ur,ur,ug,ub,ug,ug,ug,ub,ub,cb,ub,ux,ux,ur,ub,ux,ur
ur,ug,ug,ug,ug,ur,ug,ug,ur,ub,cb,ug,ug,ub,ub,ub,ub,ux,ux,ur,ux,ux,ur
ur,ug,ux,ug,ug,ur,ug,ug,ug,ub,ub,cb,ux,ug,ux,ux,ux,ux,ux,ur,ux,ux,ur
ur,ux,ux,ug,ug,ug,ug,ug,ug,ug,ug,ug,ug,ug,ug,ug,ug,ug,ux,ur,ux,ux,ur
cr,ux,ux,ux,ux,ur,ug,ug,ug,ug,ug,ug,ux,ux,ux,ux,ux,ug,ux,ur,ux,ux,ur
ub,ub,ub,ub,ub,ur,ub,ub,ug,cr,ug,ur,ug,ug,ug,ug,ug,ug,ux,ur,ur,ur,ur
ux,ux,ux,ux,ux,ur,ux,ux,ur,ur,ux,ur,ux,ux,ux,ux,ux,ux,ux,ux,ux,ux,cb
cg,ux,ux,ux,ux,ur,ux,ux,ur,ur,ux,ur,ur,ur,ur,ur,ur,ur,ur,ur,ur,ur,ur
cb,ux,ux,ux,ux,ur,ux,ux,ur,ur,ur,ur,ur,ur,ur,ur,ur,ur,ur,ur,ur,ur,ur
ur,ur,ur,ur,ur,ur,ur,ur,ur,ux,ux,ux,cg,ux,ux,ux,cb,ux,ux,ux,ux,cr,cb
cb,ur,ur,ur,ur,ur,cr,cb,cr,ux,ux,cg,cb,ux,ux,ux,cr,ux,ux,cr,ux,cr,cb