ur,ur,cr,cr,ur,cg,ug,cb,cb,cb,cg,ur,cg,ur,ux,ur,cr,ux,ux,cb,cb,ux,cb
ur,ur,ur,ur,ub,ug,ug,ur,ur,ur,ur,ur,ur,ur,ux,ur,ux,ux,ux,ux,ux,cb,cb
ur,cg,ug,ur,cr,ub,cb,ur,ur,ur,ur,ur,ur,ur,ux,ur,ux,ux,ur,ur,ux,ur,ur
cg,ur,ug,ur,ur,ug,ug,ur,ur,ur,ur,ur,ur,ur,ub,ur,ux,ux,ur,ur,ur,ur,ur
ur,ur,cr,ur,ug,ug,ug,ug,cg,ur,ur,ur,ur,ur,ur,ur,ur,ur,ur,ur,ur,ur,ur
ur,ur,ur,ur,ug,ug,ur,ur,ur,ur,ur,ur,ur,ur,ur,ur,ur,ur,ur,ur,ur,ur,ux
ur,ur,ur,ur,ug,ug,ug,ur,ug,ug,ur,ur,ur,ur,cr,ur,ub,ub,ub,ub,ur,cb,ub
ub,ub,ub,ub,ug,ug,ug,ug,ug,ub,ux,ur,ur,ur,ur,ur,ux,ux,ub,ub,ub,ub,ub
ub,ux,ux,ux,ux,ub,ub,ur,ur,ub,ux,ur,ur,ux,ux,ux,ux,ub,ub,ub,ub,ub,ub
ub,ux,ux,ux,ux,ub,ub,ub,ub,ug,cg,ub,ub,ub,ub,ug,ug,ug,ug,ub,ub,ub,ub
ub,ux,ux,ux,ux,ub,ub,ug,ug,ug,ub,ur,cr,ug,ug,ug,ug,ug,ug,ug,ug,ur,ub
ub,ub,ub,ub,ub,ub,ub,ub,ug,ub,ub,ur,ug,ug,ug,ug,ug,ug,ub,ub,ub,ub,ub
ub,ub,ub,ux,ub,ub,ub,ug,ug,ub,ub,ur,ub,ug,ub,ug,ug,cg,ub,ub,ub,ub,ub
ub,ub,ub,ub,ub,ub,ub,ub,ug,ug,ub,ur,ub,ug,ug,ug,ug,ub,ub,ub,ub,ur,ur
ux,ub,ub,ub,ub,ub,ux,ux,ug,ug,ug,ur,ug,ub,ub,ug,ux,ub,ub,ub,ub,ur,ub
ux,ub,ub,ub,ub,ub,ux,ux,ug,ug,ug,ur,ub,ub,ub,ug,ug,ub,ub,ub,ub,ur,ub
ux,ux,ux,ux,ux,ub,ux,ux,ug,ug,ug,ur,ub,ub,ub,ub,ub,ub,ub,ur,ur,ur,ur
ux,ux,ux,ux,ux,ub,ux,ub,ub,ub,ub,ur,ub,cb,ug,ug,ug,ub,cb,ur,ur,ur,ur
ux,ux,ux,cr,ur,cb,ub,ub,ub,ub,ub,ur,ub,ur,ur,ur,ur,ur,ur,ur,ur,ur,cb
cg,ux,ux,ux,ux,ux,ux,ux,ux,ux,ux,ux,ub,ub,ub,ub,ub,ub,ux,ur,ur,ur,ur
cb,ux,ux,ux,ux,ux,ux,ux,ux,ux,ux,ux,ub,ub,ub,ub,ub,ub,ux,ur,ur,ur,ur
ux,ux,ux,ux,ux,ux,ux,ux,ux,ux,ux,ux,cg,ub,ub,ub,ux,ux,ux,ur,ur,cr,ur
ux,ux,ux,ux,ux,ux,cr,ux,cr,ux,ux,cg,cb,ub,ub,ub,cr,ux,ux,cr,ur,cr,cb