ux,ux,cr,ur,ur,ur,ur,cb,cb,cb,ub,cg,cg,ux,ux,ux,ux,ux,cr,ux,cb,cb,cb
ux,ux,cb,ur,ur,cr,ur,cr,ur,ur,ub,ur,ur,ux,ux,ux,ux,ux,ur,ur,ur,ur,ur
ux,cr,ur,ur,ur,ur,ur,ur,ur,ur,ub,ur,ur,ur,ur,ur,ur,ur,ur,ur,ur,ur,ur
ux,ux,cr,ur,ur,ur,ur,ur,ug,ur,ub,ub,ub,ub,ub,ub,ux,ux,ux,ux,ux,ux,ug
ux,ux,ux,ur,ur,ur,ur,ux,cg,ur,ux,ux,ux,ux,ux,cb,ux,ux,ux,ux,ux,ux,ug
cb,ux,ux,ur,ur,ur,ur,ux,ug,ur,ux,ux,ux,ux,ux,ux,ux,ur,ur,ur,ur,ux,ug
ux,ux,ux,ur,ur,ur,ur,ur,ug,ur,ux,ux,ux,ux,ux,ux,ux,ur,ux,ux,ur,ux,ug
ux,ux,ux,ur,ur,ug,ux,ur,ur,ug,ug,ux,ux,ux,ux,ug,ux,ur,ur,ux,ur,ux,ug
ux,ux,ux,ur,ur,ug,ug,ur,ur,ur,ug,ur,ux,ux,ux,ug,ug,ux,ur,ux,ur,ux,ug
ux,ux,ux,ur,ur,ux,ug,ug,ur,ur,ug,ur,ux,ub,ub,ug,ug,ur,ur,ux,ur,ux,ug
ux,ux,ux,ur,ur,ux,ug,ug,ug,ub,ub,ub,ub,ub,ub,ug,ug,ur,ux,ux,cr,ux,ug
ux,ub,ux,ur,ug,ux,ux,ur,cr,ub,ub,ur,ur,ur,cb,ux,ug,ux,ux,ux,ux,ux,ug
ur,ub,ub,ur,ux,ux,ux,ur,ub,ug,ub,cg,ub,ub,ux,ux,ug,ux,ux,ux,ux,ux,ug
ur,cb,ub,ur,ux,ux,ux,ur,ur,ur,ux,ug,ux,ub,ux,ux,ug,ux,ux,ux,ux,ux,ug
ub,ub,ub,ur,ux,ux,ux,ux,ux,ur,ur,ug,ub,ub,ux,ux,ug,ux,ur,ur,ug,ug,ug
ub,ur,ub,cr,ux,ux,ux,ux,ux,ug,ux,ug,ux,ux,ux,ux,ug,ug,ug,ur,ug,ux,ux
ux,ub,ub,ug,ux,ux,ux,ux,ux,ug,ug,ug,ux,ux,cg,ug,ug,ug,ug,ub,ug,ub,ub
ux,ux,ux,ug,ux,ux,ux,ux,ux,ux,ux,ux,ux,ux,ux,ux,ux,ux,ug,ug,ug,ub,ub
ux,ux,ux,cg,ux,ux,ux,ux,ux,ux,ux,ux,ux,ux,ux,ux,ux,cg,ug,ux,ub,cb,ub
cg,ux,ux,ux,ux,ux,ux,ux,ux,ux,ux,ux,ux,ux,ux,ux,ux,ux,ub,ub,ub,ux,ux
cb,ux,ux,ux,ux,ux,ux,ux,ux,ux,ux,ux,ux,ux,ux,ux,ux,ux,ub,ux,ub,ux,ux
ux,ux,ux,ux,ux,ux,ux,ux,ux,ux,ux,ux,cg,ux,ux,ux,ux,ux,cb,ux,ub,cr,cb
cb,ux,cg,ux,ux,ux,cr,cb,cr,ux,ux,cg,cb,ux,ux,ux,ux,ux,ux,cr,ub,cr,cb