cr,ug,ug,ug,ug,ug,cr,cb,cb,cb,ub,cg,cg,cb,ug,ug,ug,ur,ur,ub,cb,cb,cb
ug,ug,ug,ug,ug,ug,ug,ug,ug,ug,ug,ug,ug,ug,ug,ur,ur,ur,ur,ub,ub,ub,cg
ug,ug,ug,ug,ug,ug,ug,ug,ug,ug,ub,ur,ub,ub,ur,ub,ug,ur,ur,ub,ur,ur,ur
ug,ug,ux,ug,ug,ug,ug,ug,ug,ug,ug,ug,ub,ur,ur,ub,ug,ur,ur,ub,ur,ub,ur
ug,ug,ug,ug,ug,ug,ug,cr,ur,ug,ug,cg,ug,ug,ug,ug,ug,ug,ur,ur,ur,ur,ur
ug,ug,ug,ug,ug,ub,ug,ub,ur,ur,ub,ur,ur,ub,ur,ub,ub,ub,ur,ur,ur,ur,ug
ug,ug,ur,ug,ug,ur,ug,ur,ur,ur,ub,ur,ub,ub,ur,ub,ub,ur,ur,ur,ub,ur,ug
ug,ug,ug,ug,ug,ug,ug,ug,ur,ur,ub,ur,ur,ur,ur,ub,ur,ur,ub,ur,ug,ur,ug
ug,ug,ug,ug,ug,ug,ug,ug,ur,ur,ub,ur,ur,ur,ur,ur,ur,ur,ur,ur,ur,ur,ur
ug,ug,ug,ug,ug,ug,ug,ug,cg,ur,ub,ur,ub,ub,ub,ub,ur,ub,ug,ur,ur,ur,ur
ug,ug,ug,ug,ug,ur,ug,ur,ur,ub,ub,ur,ur,ur,ur,ub,ub,ub,ug,ur,ur,ur,ur
ug,ug,ug,ug,ug,ug,ug,ur,ur,ur,ub,ur,ug,ug,ug,ug,ug,ug,ug,ur,ug,ur,ur
ug,ug,ug,ug,ug,ub,ug,ur,ur,ur,ub,ur,ur,ur,ur,ur,ur,ub,ur,ur,ur,ur,ur
ug,ug,ug,ur,ug,ug,ug,ug,ur,ug,ub,ur,ug,ug,ur,ug,ug,ug,ug,ur,ug,ur,ur
ug,ug,ub,ub,ug,ug,ug,ub,ur,ur,ur,ur,ug,ug,ug,ug,cg,ug,ug,ur,ur,ur,ur
ug,ug,ub,ub,ub,ub,ub,ub,ur,ur,ub,ur,ur,ur,ug,ug,ug,ub,ub,cr,ur,ur,ur
ug,ug,ub,cb,ub,ug,ur,ur,ur,ur,ub,ur,ur,ur,ug,ug,ur,ub,ub,ug,ub,ub,ur
ug,ug,ug,ub,ub,ub,ub,ub,ub,ub,ub,ur,ur,ur,cg,ug,ur,ur,ub,ub,ub,ur,ur
ug,ug,ug,ub,ug,ug,ug,ug,ug,ug,ub,cb,ug,ug,ug,ug,ug,ub,ux,ub,cb,ub,ub
ug,ug,ug,ug,ur,ur,ug,ur,ur,ur,ub,ub,ug,ug,ur,ug,ur,ur,ur,ub,ub,ub,ub
cb,ug,ug,ug,ug,ub,ub,ub,ub,ub,ub,ub,ub,ub,ub,ub,ub,ub,ub,ub,ub,ub,ub
ub,ug,ug,cg,ug,ur,ug,ub,ur,ur,ug,ub,cg,ug,ur,ur,ug,ug,ug,ub,ub,cr,cb
cb,ug,ug,ug,ug,ug,ug,ug,ug,ug,ug,cg,cb,ug,ug,ug,ug,cb,ug,cr,ub,cr,cb