ux,ux,cr,ur,ur,cr,ur,cb,cb,cb,cg,cg,cg,ur,ur,ur,ur,ux,ux,ux,cb,cb,cb
cg,cr,ur,ur,ur,ux,ur,ur,ur,ur,ur,ur,ur,ur,ur,ur,ur,ux,ux,ux,ux,ux,ux
ur,cr,ur,ur,ur,ux,ur,ur,cr,ur,ur,ur,ur,ur,ur,ur,ur,ur,ux,ux,ux,ux,ux
ur,ur,ur,ur,ur,ur,ur,ur,ub,ur,ur,ur,ur,ur,ur,ur,ur,ur,ur,ur,ux,ux,ux
ur,ur,ur,ur,ux,ur,ur,ub,ub,ub,ub,ug,ur,ur,ur,ur,ur,ur,ur,ur,ux,ux,ux
ub,ub,ub,cr,ux,ur,ur,ub,ur,ug,ug,ug,ug,ug,ub,ub,cr,ug,ug,ur,ur,ur,ur
ub,cb,ur,ur,ux,cr,ur,cb,ur,ur,ug,ur,ur,ub,ub,ub,ur,ur,ug,ur,ur,ur,ur
ub,ub,ub,ur,ux,ug,ub,ub,ub,ur,ur,ur,ur,cb,ug,ug,ur,ur,ug,ug,cg,ur,ur
ub,ub,ub,ur,ux,ug,ub,ub,ub,ub,ub,ub,ug,ug,ug,ub,cb,ur,ur,ur,ug,ur,ur
ub,ub,ub,ur,ux,ug,ub,ug,ug,ug,ug,ug,cg,ub,ub,ub,ug,ug,ub,ug,ug,ur,ur
ub,cb,ub,ub,ux,ug,ug,ug,ug,ub,ub,ug,ur,ub,ub,ub,ug,ug,ug,ug,ug,ug,ug
ub,ux,ub,ub,ux,ug,ug,ug,ug,ur,ub,ub,ub,ub,ub,ub,ug,ug,ug,ug,ug,ur,ur
ub,ux,ub,ub,ub,ug,ug,ub,ub,ux,ux,cg,ug,ug,ug,ug,ug,ug,ug,ug,ug,ug,ur
ub,ux,ux,ur,ug,ug,ug,ug,ug,ux,cb,ub,cg,ug,ug,ug,ug,ug,ur,ug,ug,ug,ur
ub,ur,ur,ur,cr,ug,ug,ug,ug,ug,ug,ug,ug,ug,ug,ug,ug,ug,ur,ug,ux,ux,ur
ub,ux,ur,ux,ug,ug,ux,ur,ug,ug,ug,ug,ug,ug,ug,ug,ur,ug,ur,ur,ur,ur,ur
ub,ux,ur,ux,ug,ug,ux,ur,ux,ux,ux,ux,ug,ug,ug,ug,ur,ux,ur,ur,ux,ux,ux
ub,ub,ur,ub,ug,ug,ux,ur,ux,ux,ux,ux,ug,ug,ub,ug,ur,ub,ur,ur,ux,ux,ux
ux,ux,ur,ux,ux,ub,ub,ur,ub,ub,ub,ug,ug,ub,ub,ug,ug,ub,ur,ur,ux,ux,cb
cg,ux,ur,ub,ub,ub,ub,ur,ux,ux,ux,ug,ug,ug,ug,ug,ug,ux,ur,ur,ux,ux,ux
cb,ux,ur,ur,ur,ur,ur,ur,ux,ux,ux,ux,ux,ux,ux,ug,ug,ug,ug,ur,ux,ux,ux
ux,ux,ux,ux,ux,ux,ux,ux,ux,ux,ux,ux,cg,ux,ux,ug,ug,ug,ug,ur,ux,cr,cb
cb,ux,ux,ux,ux,ux,cr,cb,cr,ux,ux,cg,cb,ux,ux,ux,cr,ux,ux,cr,ux,cr,cb