ur,ur,cr,ur,ur,ur,ur,cb,cb,cb,cg,cg,cg,ur,ur,ur,ur,ur,ur,ur,cb,cb,cb
ur,ur,ur,ur,ur,ur,ur,cg,ur,ur,ur,ur,ur,ur,ur,ur,ur,ur,ur,ur,ur,ur,ur
ur,cr,ur,ur,ur,ur,ur,ug,ur,ur,ur,ur,ur,ur,ur,ur,ur,ur,ur,ur,ur,ur,ur
cb,ur,ur,ur,cr,ur,ur,ug,ux,ux,cr,ur,ur,ur,ur,ur,ur,ur,ug,ux,ur,ur,ur
ur,ur,ur,ug,cr,cg,ur,cr,ug,ug,ub,ug,ug,ug,ug,cr,ur,ub,ub,ub,ux,ux,ur
ur,ug,cg,ur,ur,ug,ur,ur,ur,cg,ub,ub,cb,ur,ur,ur,ur,ub,ub,ub,ur,ux,ur
ur,ug,ug,ug,ug,ur,ur,ur,ug,ug,ug,ub,ub,ub,ub,ub,cb,ur,ur,ur,ur,ux,ur
cb,ub,ug,ug,ug,ur,ug,ug,ug,ug,ug,ur,ur,ub,ub,ub,ux,ub,ub,ur,ur,ux,ur
ub,ub,ug,ug,ur,ur,ug,ux,ux,ug,ur,ux,ub,ub,ug,ub,ub,ub,ux,ur,ur,ux,ur
ub,ub,ux,ux,ug,ur,ur,ug,ux,ug,ur,ub,ub,ub,ug,ug,ub,ub,ug,ur,ur,ur,ur
ub,ub,ub,ug,ug,ur,ug,ug,ug,ug,ur,ug,ug,ub,ug,cb,ug,ug,ub,ur,ub,ub,ub
ub,ub,ug,ug,ug,ur,ug,ug,ub,ub,ur,ub,ur,ub,ub,ub,ub,ub,ub,ur,ux,ux,ux
ub,ub,ub,ub,ub,ur,ub,ub,ub,ub,ur,ub,ub,ug,ub,ub,ub,ug,ub,ur,ux,ux,ux
ub,ub,ub,ux,ux,ur,ug,ug,ug,ub,ur,ug,ug,cg,ug,ub,ub,ub,ub,ur,ux,ux,ux
ub,ub,ub,ub,ub,cr,ug,ug,ug,ub,ur,ub,ub,ur,ug,ug,ux,ub,ub,ur,ux,ux,ux
ub,ub,ub,ub,ub,ux,ux,ux,ux,ub,ur,ub,ub,ub,ub,ub,ub,ub,ux,ur,ux,ux,ux
ub,ub,ux,ub,ub,ub,ux,ux,ux,ur,ur,ub,ub,ub,ub,ub,ub,ub,ub,ur,ux,ux,ux
ux,ux,ux,ux,ub,ub,ub,ub,ub,ur,ur,ux,ub,ub,ub,ub,ub,ub,ub,cr,ux,ux,ux
ux,ux,ub,ub,ub,ub,ub,ux,ux,ur,ur,ux,ub,ub,ub,ub,ub,ub,ub,ub,ux,ux,cb
cg,ux,ux,ux,ub,ux,ux,ux,ux,ur,ur,ub,ub,ub,ub,ub,ub,ub,ub,ub,ub,ub,ub
cb,ux,ux,ux,ux,ux,ux,ux,ux,ur,ur,ux,ub,ub,ub,ub,ub,ub,ub,ub,ub,ub,ub
ux,ux,ux,ux,ux,ux,ux,ux,ux,ur,ur,ux,cg,cb,ub,ub,ux,ux,ux,ux,ux,cr,cb
cb,ux,ux,ux,ux,ux,cr,ux,cr,ur,ur,cg,cb,ub,ub,ub,cr,ux,ux,cr,ux,cr,cb