ur,ur,cr,ur,ur,ur,ur,cb,cb,cb,cb,cg,cg,ur,ur,ur,ur,ur,ur,ur,cb,cb,cb
ur,ur,cb,ur,ur,ur,ur,ur,ub,ub,ub,ur,ur,ur,ur,ur,ur,ur,ur,ur,ur,ur,ur
ur,cr,ur,ur,ur,ur,ur,ur,ur,cr,ur,ur,ug,ug,ug,ug,ug,ug,ug,ug,cg,ur,ur
ur,ur,ur,ur,ur,ur,ur,ur,cr,ur,ur,ur,cr,ur,ur,ur,ur,ur,ur,ur,ur,ur,ur
ur,ur,ur,ur,ur,ur,ur,ur,ur,ur,ur,ur,ur,ug,ug,ug,ug,ug,ur,ur,ur,ur,ur
cb,ur,ur,ur,cg,ur,ur,ur,ur,ur,ur,ur,ur,ur,ur,ur,ur,ug,ug,ur,ur,ur,ur
ur,ur,ur,ur,ug,ur,ur,ur,ur,ur,ur,ur,ur,ur,ur,ur,ur,ug,ug,ur,ug,ur,ur
ur,ur,ur,ur,ug,ur,ur,ur,ur,ur,ur,ur,ur,ur,ur,cg,ur,ug,ug,ug,ug,ur,ur
ur,ur,ur,ur,ug,ur,ur,ur,cr,ug,ur,ur,ur,ur,ur,ug,ug,ug,ug,ug,ur,ur,ur
ur,ur,ur,ur,ug,ur,ur,ur,cg,ug,ur,ur,ub,ub,ub,ub,ug,ug,ug,ug,ur,ur,ur
ur,ur,ur,ur,ug,ur,ur,cg,ug,ub,ur,cr,ur,ub,ub,ub,ug,ug,ug,ug,ug,ug,ur
ur,ur,ur,ur,ug,ur,ur,ur,ug,ub,ur,ug,ub,ub,ub,ur,ug,ur,ug,ug,ur,ug,ur
ur,ur,ur,ug,ug,ur,ur,ur,ug,ub,ur,ug,ub,ub,ub,ub,ug,ur,ug,ur,ur,ur,ur
ur,ur,ur,ug,ug,ur,ur,ur,ur,ub,ub,ub,ub,ur,ub,ur,ug,ug,ug,ur,ur,ur,ur
cb,ur,cr,ug,ug,ur,ur,ur,ur,cb,ur,ur,ur,ur,ub,ur,ug,ur,ur,ur,ur,ur,ur
ur,ur,ur,ug,ug,ur,ur,ur,ur,ur,ur,ur,ur,ur,ur,ur,ug,ug,ur,cr,ur,ur,ur
ub,ub,ub,ug,ug,ur,ur,ur,ur,ur,ur,ur,ur,ur,ur,ug,ur,ur,ur,ur,ur,ur,ur
ur,ur,ur,ug,ug,ur,ur,ur,ur,ur,ur,ur,ur,ur,ug,ug,ur,ub,ub,cb,ur,ur,ur
ur,ur,ur,ug,ug,ur,ur,ur,ur,ur,ur,ur,ur,ur,ug,ur,ur,ub,ub,ub,ur,ur,ur
cg,ur,ur,ug,ug,ur,ur,ur,ur,ur,ub,ur,ug,ur,ug,ur,ur,ub,ur,ub,ur,ub,ur
cb,ur,ur,ug,ug,ur,ur,ur,ur,ur,ur,ur,ug,ur,ug,ug,ug,ub,ur,ub,ub,ub,ur
ug,ur,ur,ug,ug,ur,ug,ug,ur,ur,ur,ur,cg,ur,ur,ur,ur,ur,ur,ub,ub,cr,cb
cb,ug,cg,ur,ur,ur,cr,cb,cr,ur,ur,cg,cb,ur,ur,ur,ub,ub,ub,cr,cb,cr,cb