ur,ur,cr,ur,ur,ur,ur,cb,cb,cb,cg,cg,cg,ux,ux,ub,ur,ur,ur,ur,cb,cb,cb
ur,ur,ur,ur,ur,ur,ur,ug,ux,ux,ux,ux,ux,ub,cb,ub,ur,ub,ur,ur,ur,ur,ur
ur,cr,ur,cr,ur,ur,ur,ug,ur,ur,ur,ur,ur,ub,ux,ur,ur,ur,ur,ur,ur,ub,cr
cb,ur,ur,ug,cg,ug,cg,ug,ur,ur,ur,ur,ur,ur,ur,ur,ur,ur,ur,ur,ur,ub,ub
ur,ur,cr,ur,ur,ur,ur,ug,ur,ur,ur,ur,ur,ur,ur,ur,ur,ur,ur,ur,ur,ub,ub
ur,ur,ur,ur,ur,ur,ur,ug,ux,ux,ur,ur,ur,ur,ur,ur,ur,ur,ur,ub,ub,ub,ub
ur,ur,ur,ug,cr,ur,ur,ug,ur,ur,ur,ur,ur,ur,ur,ur,ur,ur,ur,ub,ur,ur,ub
ur,ur,ur,ur,ur,ur,ur,ug,ug,cg,ur,ug,ug,ur,ur,ur,ur,ur,ur,ub,ub,ub,ub
ur,ur,ur,ur,ur,ur,cb,ur,ug,ur,cr,ug,ug,ur,ur,ur,ur,ub,ub,ub,ub,ub,ub
ur,cr,ur,ur,ur,ur,ub,ur,ug,ur,ur,ug,ug,ur,ur,ur,ur,ub,ub,ub,ux,ux,ub
ur,ux,ur,ur,cr,ur,ub,ur,ur,ur,ug,ug,ub,ub,ur,ug,ug,ug,ug,ug,ub,ub,ub
ur,ux,ux,ur,ur,ur,ub,ub,ub,ub,ub,cg,ub,ub,ug,ug,ug,ug,ug,ug,ub,ug,ux
ur,ur,ur,ur,ur,ur,ug,ur,ur,ur,ur,ur,ur,ux,ug,ur,ug,ug,ug,ug,ub,ug,ux
ur,ur,ur,ur,ur,ur,ug,ur,ur,ur,cb,ux,ur,ur,ug,ug,ug,ug,ug,ug,cb,ug,ux
ur,ur,ur,ur,ur,ur,ur,ur,ur,ur,ur,ur,ur,ur,ur,ur,ug,ug,cg,ur,ur,ux,ux
ux,ux,ux,ux,ux,ur,ur,ur,ux,ug,ug,ug,ug,ug,ug,ug,ug,ug,ux,ux,ux,ux,ux
ux,ur,ur,ur,ur,ur,ur,ur,ur,ur,ux,ug,ur,ur,ur,ur,ur,ur,ur,ur,ur,ur,ur
ux,ur,ur,ur,ur,ur,ur,ur,ur,ur,ur,ur,ur,ur,ur,cb,ur,ur,ur,ur,ur,ur,ux
ur,ur,ur,ub,ub,ub,ub,ub,ub,ur,ug,ug,ur,ug,ug,ub,ub,ub,ub,ub,ub,ux,cb
cg,ux,ux,ux,ub,ub,ub,ub,ub,ub,ug,ug,ug,ug,ux,ux,ux,ub,ub,ub,ub,ux,ux
cb,ux,ux,ux,ub,ub,ux,ux,ub,ub,ub,ub,ux,ux,ux,ux,ux,ub,ub,ub,ub,ux,ux
ux,ux,ux,ux,ux,ub,ux,ux,ub,ub,ub,ub,cg,ux,ux,ux,ux,ux,ux,ux,ux,cr,cb
cb,ux,ux,ux,ux,ux,cr,ux,cr,ub,cb,cg,cb,ux,ux,ux,cr,ux,ux,cr,ux,cr,cb