cr,ur,cr,ur,ur,ur,ur,cb,cb,cb,cg,ur,cg,ur,ur,ub,ub,cb,ub,cb,cb,ur,cb
ur,ur,ur,ur,ur,ur,ur,ur,ur,ur,ur,ur,ur,ur,ur,ub,ub,ub,ub,ub,ub,cb,cb
ur,cr,ur,ur,cg,ur,ur,ur,ur,ux,ux,ur,ur,ur,ur,ub,ub,ub,ux,ur,ur,ur,ur
cg,ur,ug,cr,ug,ur,ur,ur,ur,ur,ur,ur,ur,ur,ur,ur,ur,ur,ur,ur,ur,ur,ur
ur,cg,ug,ur,ug,ug,ur,ur,ur,cr,ug,ug,ub,ub,ur,ur,ur,ur,ur,ur,ur,ur,ur
ur,ug,ug,ur,cr,cg,ug,ur,ur,ur,ug,ur,ur,ur,ur,ur,ur,ur,ur,ur,ur,ur,ur
ur,ur,ur,ur,ur,ug,ug,ur,ur,ug,ug,ug,ug,ug,ug,ux,ux,ub,ub,ub,ur,ur,ur
ur,ur,ur,ug,ur,ug,ug,ug,ug,ug,ug,ug,ug,ug,ub,ub,ub,ub,ub,ub,ur,ur,ur
ur,ur,ur,ug,ur,ug,ug,ug,ub,ug,ug,ug,ug,ub,ux,ub,ub,ux,ub,ub,ur,ur,ur
ur,ur,ur,ug,ur,ub,ub,cg,ux,ub,ub,ub,ub,ub,ub,ub,ur,ub,ub,ub,ub,cb,ur
ur,ur,ur,ur,ur,ux,ur,ur,ur,ub,cb,ub,ur,ur,ur,ub,ub,ug,ug,ug,ur,ub,ur
ur,ur,ur,ur,ur,ur,ur,ub,ub,ub,ub,ub,ub,ub,ug,ug,ug,ug,ub,ub,ur,ur,ur
ur,ux,ux,ux,ub,ux,ur,ug,ug,ub,ub,ub,ub,ub,ug,cg,ux,ub,ub,ub,ur,ur,ur
ur,ux,ux,ux,ub,ux,ur,ug,ug,ug,ug,ur,ug,ur,ur,ur,ub,ub,ub,ur,ur,ur,ur
ur,ux,ux,ux,ub,ux,cr,ux,ux,ux,ux,ur,ug,ur,ug,ux,cb,ub,ub,ug,ur,ux,ur
ur,ux,ux,ux,ub,ux,ux,ux,ux,ux,ux,ur,ur,ur,ug,ug,ug,ug,ug,ug,ur,ux,ur
ur,ur,ur,ur,ur,ur,ur,ur,ur,ur,ur,ur,ur,ur,ug,ur,ug,ug,ug,ug,cr,ur,ur
ub,ub,ub,ub,ub,ux,ux,ux,ux,ux,ux,ux,ux,ux,ug,ug,ug,ug,ug,ug,ur,ur,ur
ub,ub,ub,ux,ub,ux,ux,ux,ux,ux,ux,ux,ux,ux,ux,ux,ux,ur,ur,ur,ur,ur,cb
cg,ub,ub,ux,ub,ux,ux,ux,ux,ux,ux,ux,ux,ux,ux,ux,ux,ur,ur,ur,ur,ur,ur
cb,ub,ub,ux,ux,ux,ux,ux,ux,ux,ux,ux,ux,ux,ux,ux,ux,ux,ur,ur,ur,ur,ur
cb,ub,ub,ub,ub,ux,ux,ux,ux,ux,ux,ux,cg,ux,ux,ux,ux,ux,ux,ux,ux,cr,ur
ub,ub,ub,ub,ub,ux,cr,ux,cr,ux,ux,cg,cb,ux,ux,ux,cr,ux,ux,cr,ux,cr,cb