ux,ux,cr,ur,ur,ur,ur,cb,cb,cb,cg,cg,cg,ur,ur,ur,ur,ur,ur,ur,cb,cb,cb
ur,ur,ur,cr,ur,ur,ur,ur,ur,ur,ur,ur,ur,ur,ur,ur,ur,ur,ur,ur,ur,ur,ur
ur,cr,ur,cg,cr,ur,ur,ur,ur,ur,ur,ur,ur,ur,ur,ur,ur,ur,ur,ur,ur,ur,ur
cb,ur,ur,ug,ur,cr,ur,ur,ur,ur,ux,ux,ur,ur,ur,ur,ur,ur,ur,ur,ux,ur,ur
ur,ur,ur,cr,ur,ur,ug,ug,ug,ur,ur,ur,ug,ug,cr,ub,ub,ub,ug,ur,ur,ur,ur
ur,ur,ur,ur,ur,ur,ug,ug,ug,ub,ub,ur,ug,ug,ur,ug,cb,ub,ug,ur,ur,ur,ur
ur,ur,ur,ur,ur,ur,ug,ug,ug,ub,ub,ub,ug,cg,ur,ur,ur,ur,ug,ug,ur,ur,ur
ur,ur,ur,ur,ur,cg,ug,ur,ur,ur,ur,ur,ur,ur,ur,ub,ub,ur,ug,ug,ug,ur,ur
ur,ur,ur,ur,ur,ug,ur,ug,ug,ub,ug,ug,ug,ur,ub,ug,ug,ug,ug,ug,ug,ur,ur
ur,ur,ur,ur,ug,ug,ur,ug,ug,ub,ug,ug,ug,ur,ub,ub,ub,ub,ug,ug,ub,cb,ur
ur,ur,ux,ug,cg,ug,ur,ug,ug,ub,ub,ug,ug,ur,ub,ub,ux,ux,cg,ux,ug,ug,cr
ur,ur,ur,ur,ur,ug,cr,ug,ug,ub,ub,ub,ub,ub,ub,ug,ug,ug,ug,ug,ug,ug,ur
ur,ur,ur,ur,ur,ur,ur,ur,ur,ur,ub,ur,ub,ur,cb,ug,ux,ug,ug,ug,ug,ug,ur
ux,ux,ux,ux,ux,ur,ur,ur,ur,ur,ub,ux,ub,ur,ub,ug,ug,ux,ux,ug,ug,ug,ur
ux,ux,ux,ur,ur,ub,ub,ub,ux,ux,ux,ux,ux,ur,ub,ub,ub,ug,ug,ug,ug,ux,ur
ux,ux,ux,ur,ur,ub,ub,ub,ub,ub,ub,ub,ub,ur,ub,ub,ub,ur,ur,ur,ur,ur,ur
ux,ux,ux,ux,ux,ux,ux,ub,ub,ub,ub,cb,ub,ub,ub,ur,ur,ur,ur,ux,ub,ux,ux
ux,ux,ux,ux,ux,ux,ub,cb,ub,ub,ub,ub,ub,ub,ub,ub,ub,ub,ur,ub,ub,ux,ux
ux,ux,ux,ux,ux,ux,ub,ux,ux,ub,ub,ub,ub,ub,ur,ub,ub,ub,ur,ub,ub,ux,cb
cg,ux,ux,ux,ux,ux,ux,ub,ub,ub,ub,ux,ub,ub,ur,ub,ux,ux,ur,ux,ub,ux,ux
cb,ux,ux,ux,ux,ux,ub,ub,ub,ub,ub,ub,ub,ub,ub,ub,ux,ub,ur,ub,ub,ux,ux
ux,ux,ux,ux,ux,ux,ub,ub,ub,ub,ub,ub,cg,ub,ub,ur,ur,ur,ur,ux,ux,cr,cb
cb,ux,ux,ux,ux,ux,cr,ub,cr,ub,ub,cg,cb,ur,ur,ur,cr,ux,ux,cr,ux,cr,cb