cr,ub,cr,ub,ub,ub,cb,cb,cb,cb,ux,cg,cg,ug,ug,ug,ug,ug,ug,ug,cb,cb,cb
cr,cr,ur,ur,ur,ur,ux,cr,ur,ur,ur,ur,ur,ug,ur,ur,ur,ur,ur,ug,ux,ux,ux
cb,cr,ur,ur,ub,ur,ur,ur,ur,ur,ur,ux,ux,ug,ur,ur,ur,ur,ur,ug,ux,ux,ux
ub,cr,ub,ur,ub,ub,ub,ux,ux,ur,ur,ur,ur,ug,ur,ur,ux,ux,ux,ug,ux,ux,ux
ub,ub,ub,ux,ux,ux,ux,ux,ux,ur,ur,ur,ux,cg,ur,ux,ux,ux,ux,ug,ux,ux,ux
ur,ux,ur,ux,ux,ux,ux,ux,ux,ux,ux,ux,ux,ux,ur,ux,ux,ux,ux,ug,ux,ux,ux
ur,ux,ur,ux,ux,ux,ux,ux,ux,ux,ux,ux,ux,ux,ur,ux,ux,ux,ux,ug,ux,ux,ux
ur,ux,ur,ux,ux,ux,ux,ux,ux,ux,ux,ux,ux,ux,ur,ux,ux,ux,ux,ug,ux,ux,ux
ur,ur,ur,ur,ux,ux,ux,ux,ux,ux,ux,ux,ux,ux,ur,ux,ux,ux,ux,ug,ux,ux,ux
ug,ug,ug,ug,ug,ug,ug,cb,ub,ub,ub,ub,ub,ub,ur,ub,ux,ux,ux,ug,ux,ux,ux
ug,ur,cg,ux,ux,ux,ug,ux,ux,ux,ux,cr,ux,ux,cr,ub,ux,ux,ux,ug,ux,ux,ux
ug,ur,ug,ug,ug,ug,ug,ux,ux,ub,ub,ur,ub,ub,ub,ub,ug,ug,ug,ug,ux,ux,ux
ug,ub,ug,ug,ur,ur,ur,ux,ux,ub,ux,ur,ug,ub,ub,ug,ug,ug,ug,ug,ux,ux,ux
ug,ub,ug,ug,ug,ug,ug,ug,ug,ug,ug,ur,ub,ub,ub,ux,ux,ub,ub,ug,ux,ux,ux
ug,ub,ub,ub,ur,ug,ug,ug,ux,ub,ub,ur,ux,ux,ux,ux,ux,ub,ub,ub,ux,ux,ux
ug,cg,ur,ur,ur,ug,ug,ug,ug,ug,cg,ur,ux,ux,ux,ux,ux,ub,ub,ub,ux,ux,ux
ur,cb,ur,ur,ur,ur,ur,ur,ur,cr,ux,ur,ux,ux,ug,ug,ug,ub,ug,ub,ub,ux,ux
ug,ug,ux,ux,ux,ub,ub,ub,ub,ug,ub,cb,ub,ub,ub,ux,ub,ub,ux,ux,ub,ux,cg
ug,ug,ug,ug,ug,ub,ub,ug,ub,ux,ug,ur,ux,ub,ub,ub,ub,ux,ub,ub,ub,ux,cb
cg,ux,ug,ux,ux,cb,ub,ub,ub,ub,ub,ur,ux,ux,ux,ux,ux,ux,ub,ub,ux,ux,ux
cb,ux,ug,ug,ug,ug,ug,ug,ug,cg,ug,ug,ug,ux,ux,ux,ux,ux,ux,ux,ux,ux,ux
ux,ux,ux,ux,ux,ux,ur,ur,ur,ur,ur,ur,cg,ux,ux,ux,ub,ub,ub,ux,ux,cr,cb
cb,ux,ux,ux,ux,ux,cr,cb,cr,ux,ux,cg,cb,ux,ux,ux,ub,cb,ub,cr,ux,cr,cb