ur,ur,cr,ur,ur,cr,ur,cb,cb,cb,cg,cg,cg,ur,ur,ur,ur,ur,ur,ur,cb,cb,cb
cg,cb,ub,ur,ur,ur,ur,ur,ur,ur,ux,ur,ur,ur,ur,ur,ur,ur,cr,ur,ux,ux,ux
ur,cr,ub,cr,cr,cr,ur,ur,ur,ur,ur,ur,ux,ur,cr,ub,ux,ur,ux,ux,ux,ux,ux
ur,ur,ub,cb,ub,ur,ur,ur,ur,ur,ur,ur,ur,ur,ub,ub,ur,ur,ug,ug,ux,ux,ux
ur,ur,ur,ur,ub,ur,ur,ur,ur,ur,ur,ur,cb,ub,ub,ur,ur,ur,ux,ug,ux,ux,ux
ur,ur,ur,ur,ub,ur,ur,ur,ug,ug,ug,ug,cg,ub,ub,ub,ub,ug,ug,ug,ux,ux,ux
ur,ur,ur,ug,ug,ug,ug,ug,ug,ug,ur,ur,ur,ub,ub,ub,ub,ux,ug,ug,ug,ur,ux
ub,ub,ub,ug,ug,ug,ug,ug,ug,ug,ur,ur,ur,ub,ub,ug,ug,ug,ug,ug,ug,ur,ux
ub,ub,ub,ux,ux,ug,ub,ur,ur,ur,ug,ug,ug,ug,ug,ug,ug,ug,ug,ur,ug,ux,ux
ub,ub,ub,ug,ug,ug,ub,ug,ug,ug,ug,ug,ug,ug,ug,ur,ur,ug,ub,ug,ug,ur,ux
ub,ug,ug,ug,ux,ug,ug,ug,ug,ub,ug,ug,ug,ub,ug,ur,ug,ug,ug,ug,ug,ux,ux
ub,ug,ug,ug,ug,ug,ug,ug,ug,ux,ub,ub,ub,cb,ug,ug,ug,ug,ug,ug,ug,ur,ur
ub,ug,ug,ug,ug,ug,ug,ug,ug,ub,cg,ug,ug,ub,ug,ug,ub,ug,ug,ug,ug,ux,ur
ux,cg,ug,ug,ug,ug,ug,ug,ux,ub,cb,ug,ub,ub,ub,ur,ug,ug,cg,ux,ux,ux,ur
ux,ub,ub,ur,ur,ug,ur,ug,ur,ub,ub,ub,ub,ub,ub,ur,ur,ur,ur,ux,ux,ux,ur
ux,ub,ub,ux,ug,ug,ug,ug,ux,ub,ub,ub,ub,ub,ub,ur,ux,ug,ur,ur,ur,ur,ur
ux,ub,ur,ux,ug,ug,ux,ur,ux,ux,ux,ux,ug,ug,ug,ur,ux,ux,ur,ux,ux,ux,ux
ub,ub,ub,ux,ug,ug,ux,ur,ux,ux,ux,ux,ux,ux,ux,ur,ux,ux,ur,ux,ux,ux,ux
cb,ub,ub,ux,ux,ux,ux,ur,ux,ux,ux,ux,ux,ux,ux,ur,ug,ux,ur,ux,ux,ux,cb
cg,ux,ub,ux,ux,ux,ux,ur,ux,ux,ux,ux,ux,ux,ug,ur,ug,ux,ur,ur,ux,ux,ux
cb,ub,ub,ur,ur,ur,ur,ur,ux,ux,ux,ux,ux,ux,cr,ur,ug,ug,ug,ur,ux,ux,ux
ux,ub,ux,ux,ux,ux,ux,ux,ux,ux,ux,ux,cg,ux,ur,ur,ug,ug,ug,ur,ux,cr,cb
cb,ux,ux,ux,ux,ux,cr,cb,cr,ux,ux,cg,cb,ux,ur,ur,cr,ux,ux,cr,ux,cr,cb