ug,ug,cr,ur,ur,ur,ur,cb,cb,cb,ur,cg,cg,ur,ur,ur,ur,ur,ur,ur,cb,cb,cb
ug,cg,ur,ur,ur,ur,ur,ur,ur,ur,ur,ur,cg,ur,ur,ur,ur,ur,ur,ur,ur,ur,ur
ug,cr,cb,ur,ur,ur,ur,ur,ur,ur,ur,ur,ur,ur,ur,ur,ur,ur,ur,ur,ur,ur,ur
ug,ur,ur,ur,ur,ur,ur,ur,ur,ur,ur,ur,ur,ur,ur,ur,ur,ur,ur,ur,ur,ur,ur
ug,ur,ur,ur,ur,ur,ur,ur,ur,ur,ur,ur,ur,ur,ur,ur,ur,ur,ur,ur,ur,ur,ur
ug,ur,ur,ur,ur,ur,ur,ur,ur,cr,ur,ur,ur,ur,ur,ur,ur,ur,ur,ur,ur,ur,ur
ug,ur,ur,ur,ur,ur,ur,ur,ur,ur,ub,ur,ur,ur,ur,ur,ur,ur,ur,ur,ur,ur,ur
ug,ur,ur,ur,ur,ur,ur,ur,ur,ur,ub,ur,ur,ur,ur,ur,ur,ur,ur,ur,ur,ur,cb
ug,ug,ur,ur,ur,ur,ur,ur,cg,ur,cb,cr,ur,ur,ur,ur,ur,ur,ur,ur,ur,ur,ur
ug,ug,ur,ur,ur,ur,ur,ur,ur,ur,ur,ur,ur,ur,ur,ug,ug,ur,ur,ur,ur,ur,ur
ug,ug,ur,ur,ur,ur,ur,ur,ur,ur,ur,ur,ur,cg,ur,ug,ug,ur,ur,ur,ur,ur,ur
ug,ug,ur,ur,ur,ub,ur,ur,ur,ur,ur,ur,ug,ug,ur,ug,ug,ur,ur,ur,ur,ur,ur
ug,ug,ur,ur,ub,cr,ur,ur,ur,ur,ur,ug,ug,ug,ug,ug,ug,ur,ur,ur,ur,ur,ur
ur,ur,ub,ur,ub,ur,ur,ur,ur,ur,ug,ug,ug,ug,ug,ug,ug,ur,ur,ur,ur,ur,ur
ur,ur,ur,ur,cr,ub,ur,ur,ur,ur,ur,ur,ug,ug,ug,ug,ur,ur,ur,ur,ur,ur,ur
ur,ur,cr,ub,ur,ur,ur,ur,ur,ur,ur,ug,cg,ug,ur,ur,ur,ur,ur,ur,ur,ur,ur
ur,cb,ub,ub,ub,ub,ur,ur,ur,ur,ur,ug,ug,ug,ur,ur,ur,ur,ur,ur,ur,ur,ur
ur,ub,ub,ur,ub,ub,ub,ub,ur,ur,ur,ur,ur,ug,ur,ur,ur,ur,ur,ur,ur,ur,ur
ur,ur,ur,ur,ub,cb,ub,ub,ub,ur,ur,ur,ur,ug,ur,ur,ur,ur,ur,ur,ur,ur,ur
cg,ur,ur,ur,ur,ur,ub,ub,ub,ur,ur,ur,ur,ug,ur,ur,ur,ur,ur,ur,ur,ur,ur
cb,ur,ur,ur,ur,ur,cb,ub,ub,ub,ub,ur,ur,ug,ur,ur,ur,cr,ur,ur,ur,ur,ur
ug,ug,ug,ug,ub,ur,ur,ub,ub,ub,ur,ur,cg,cb,ub,cr,ur,ur,ur,ur,ur,cr,cb
cb,ug,ug,ur,ur,ur,cr,cb,cr,ub,ub,cg,cb,ur,ur,ur,ur,ur,ur,cr,ur,cr,cb