cb,ur,cr,ur,ur,cr,ur,cb,cb,cb,cg,cg,cg,ur,ur,ur,ur,ur,ur,ur,cb,cb,cb
cg,ur,ur,ur,cr,ur,ur,ur,ub,ub,ub,cb,ur,ur,ur,ur,ur,ur,ur,ur,ur,ur,ur
ur,cr,ur,ur,ur,ur,ur,ur,ub,ur,ur,ur,ur,ur,ur,ur,ur,ur,ur,ur,ur,cr,ur
ur,ur,ur,ur,ur,ur,ur,ur,ub,ub,cr,ur,ur,ur,ur,ur,ur,ur,ug,ug,ux,ux,ux
ur,ur,ur,ur,ug,ug,ug,ug,cr,cb,ug,ug,ug,ug,ub,ur,ur,ur,ux,ug,ux,ux,ux
ur,ur,ur,ur,ug,ur,ur,ur,ur,ub,ug,ug,ug,ug,ub,ub,ub,ug,ug,ug,ux,ux,ux
ur,ur,ur,ur,cg,ur,ur,ur,ur,ub,ur,ur,ur,ub,ub,ub,ub,ux,ug,ug,ug,ur,ux
ub,ub,ub,ub,ub,ub,cr,ur,ub,ub,cg,ug,ug,ub,ub,ug,ug,ug,ug,ug,ug,ur,ux
ub,ub,ub,ux,ux,ug,ub,ur,ur,ur,ug,ug,ug,ug,ug,ug,ug,ug,ug,ur,ug,ux,ux
ub,ub,ub,ug,ug,ug,ub,ug,ug,ug,ug,ug,ug,ug,ug,ur,ur,ug,ub,ug,ug,ux,ux
ub,ug,ug,ug,ux,ug,ug,ug,ug,ux,ug,ug,ug,cb,ug,ur,ug,ug,ug,ug,ug,ux,ux
ux,ug,ug,ug,ug,ug,ug,ug,ug,cg,ub,ub,ub,ub,ub,ub,ug,ug,ug,ug,ug,ur,ur
ux,ug,ug,ug,ug,ug,ug,ug,ug,ug,ug,ug,ub,ub,ub,ub,ub,ug,ug,ug,ug,ux,ur
ux,ug,ug,ug,ug,ug,ug,ug,ux,ub,cb,ug,ug,ug,ug,ug,ug,ug,ug,ux,ux,ux,ur
ux,ug,ug,ug,ug,ug,ug,cr,ur,ur,ur,ur,ur,ur,ur,ug,ug,ug,ug,ux,ux,ux,ur
ux,ub,ub,ux,ux,ug,ug,ug,ux,ub,ub,ub,ub,ub,ur,ur,ux,ux,ux,ux,ux,ux,ur
ux,ub,ur,ux,ux,ug,ug,cg,ux,ux,ux,ux,ug,ug,ur,ur,ux,ux,ux,ux,ux,ux,ux
cb,ub,ub,ux,ux,ug,ux,ur,ux,ux,ux,ux,ux,ux,ur,ur,ux,ux,ux,ux,ux,ux,ux
ub,ub,ub,ux,ux,ux,ux,ur,ux,ux,ux,ux,ux,ux,ur,ur,ux,ux,ux,ux,ux,ux,cb
cg,ux,ub,ux,ux,ux,ux,ur,ux,ux,ux,ux,ux,ux,ur,ur,ux,ux,ux,ux,ux,ux,ux
cb,ub,ub,ur,ur,ur,ur,ur,ux,ux,ux,ux,ux,ux,ur,ur,ux,ux,ux,ux,ux,ux,ux
ux,ub,ux,ux,ux,ux,ux,ux,ux,ux,ux,ux,cg,ux,ur,ur,ux,ux,ux,ux,ux,cr,cb
cb,ux,ux,ux,ux,ux,cr,cb,cr,ux,ux,cg,cb,ux,ur,ur,cr,ux,ux,cr,ux,cr,cb