ur,ur,cr,ur,ur,ur,ur,cb,cb,cb,cg,ur,cg,ur,ur,ur,ur,ur,ur,ur,cb,ur,cb
ur,ur,ur,ur,ur,ur,ur,ur,ur,ur,ur,ur,ur,ur,ur,ur,ur,ur,ur,ug,ug,ug,ug
ur,cr,ur,ur,ug,cg,ur,ur,ur,ur,ur,ur,ur,ur,ur,ur,ur,ub,ub,ub,ub,ur,ug
cb,ug,cg,ur,ug,ug,ur,ur,ub,ub,cr,ub,ur,ur,ur,ur,ur,ub,ub,ub,ub,ug,ug
ur,ur,cr,ug,cr,ur,ur,ur,ub,ub,ur,ur,ur,ur,ur,ub,ub,ub,ug,ug,ug,ug,ug
ur,ur,ug,ug,ur,ur,ur,ur,ur,ub,ur,ur,cb,ur,ur,ur,ug,ur,ur,ur,ur,ur,ug
ur,ur,ur,ur,ur,ur,ur,ub,ur,ub,cr,ur,ub,ur,ur,ug,ug,ur,ug,ug,ub,ub,ub
ub,ur,ur,ur,ur,ur,ub,ub,ur,cg,ur,ur,ub,ug,ub,ug,ug,ur,ug,ug,ub,ub,ub
ub,ur,ur,ux,ux,ux,ux,ux,ur,ug,ug,ug,ug,ug,ug,ug,ug,ur,ug,ux,ub,ub,ub
ub,ur,ur,ux,ux,ux,ux,ux,ur,ub,ub,ux,ub,ug,ug,ug,ug,ur,ug,ux,ub,ub,ub
ub,ub,ub,ux,ux,ux,ux,ux,ur,ug,ub,ux,ub,ug,ug,ug,ug,ug,ux,ux,ub,ub,ub
ub,ub,ub,ux,ux,ux,ux,ux,ur,ug,ug,ux,ub,ug,ug,ug,ug,ug,ux,ux,ub,ub,ub
ub,ub,ub,ub,ub,ug,ug,ug,ug,ug,ug,ub,ub,ux,ux,ug,ug,ug,ux,ux,ub,ub,ub
cb,ur,ur,ux,ub,ug,ux,ug,ug,ug,ug,ub,ub,cr,ur,ur,ur,cb,ub,ub,ub,ub,ub
ur,ur,ur,ux,cg,ug,ug,ug,ug,ug,ub,ub,ub,ug,ug,ug,ux,ug,ux,ux,ug,ub,ur
ur,ur,ur,ur,ug,ug,ug,ug,ur,ub,ub,ur,ub,ub,ub,ug,ug,ug,ux,ux,ug,ub,ur
ur,ur,ux,ux,ux,ub,ub,ub,cb,ub,ux,ux,ux,ux,ub,ub,ux,ux,ux,ux,ug,ub,ur
ur,ur,ur,ur,ur,ub,ur,ub,ur,ur,ur,ur,ur,ur,cb,cg,ug,cr,ug,ug,ug,ur,ur
ub,ub,ur,ub,ub,ub,ub,ub,ub,ur,ur,ur,ur,ur,ub,ub,ug,ur,ub,ur,ur,ub,cb
cg,ub,ub,ub,ub,ub,ub,ub,ub,ux,ux,ux,ux,ux,ux,ux,ug,ur,ub,ur,ur,ur,ur
cb,ub,ub,ub,ub,ub,ub,ub,ub,ur,ur,ur,ur,ur,ur,ur,ur,ur,ur,ur,ur,ur,ur
ux,ub,ub,ub,ux,ub,ub,ub,ub,ux,ux,ux,cg,ux,ux,ux,ur,ur,ur,ur,ux,cr,cb
ub,ux,ux,ur,ur,ur,cr,ub,cr,ux,ux,cg,cb,ux,ux,ux,cr,ux,ux,cr,ux,cr,cb