ur,ur,cr,cb,ur,ur,ub,cb,cb,cb,ur,cg,cg,ur,ur,ur,ur,ur,ur,ur,cb,cb,cb
ur,ur,ur,ur,cr,ur,ur,ur,cb,ur,ur,ur,ur,ur,ur,ur,ur,ur,ur,ur,ur,ur,ur
ur,cr,cb,ur,ur,ur,ur,ur,ur,ur,ur,ur,ur,ur,ur,ur,ur,ur,ur,ur,ur,ur,ur
ur,ur,ur,ur,ur,ur,ur,ur,ur,ur,ur,ur,ur,ur,ur,ur,ur,ur,ur,ur,ur,ur,ug
ur,ur,ur,ur,ur,ur,ur,ur,ur,ur,ur,ur,ur,ur,ur,ur,ur,ur,ug,ur,ur,ur,ug
cg,ur,ur,ur,ur,ur,ur,ur,ur,ur,ur,ur,ur,ur,ur,ur,ur,ur,ur,ur,ur,ub,ug
cg,ur,ur,ur,ur,ur,ur,ur,ur,cr,ur,ur,ur,ur,ur,ur,ur,ur,ub,ur,ug,ur,ug
cg,ur,ug,ug,ug,ur,ur,ur,ur,ur,ur,ur,ur,ur,ur,ur,ur,ur,ug,ur,ug,ur,ug
ug,ug,ug,ug,ug,ur,ub,ur,cg,ur,ur,ug,ug,ur,ur,ug,ug,ur,ur,ur,ug,ur,ug
ug,cr,ur,ur,ug,ur,ur,ur,ur,cr,ur,ur,ur,ur,ur,ur,ug,ur,ur,ur,ur,ur,ug
ug,ug,ug,ur,ug,ub,ub,ur,ug,ub,ur,ub,ub,ub,ur,ug,ug,ur,ur,ur,ur,ur,ug
ug,ug,ug,ur,ug,ub,ub,ur,ur,ub,ur,ub,ub,ur,ur,ur,ug,ur,ur,ur,ur,ur,ug
ug,ub,ub,ur,ub,ub,ug,ug,ur,ug,ur,ur,ub,ug,ug,ug,ur,ur,ur,ur,ur,ur,ur
ug,ub,ug,ur,ub,ub,ug,ug,ur,ug,ur,ur,ub,ug,ug,ug,ur,ur,ur,ur,ur,ur,ur
cg,ub,ug,ur,ub,ug,ug,ug,ug,ug,ug,ug,ug,ug,ug,cr,ug,ug,ug,ug,ug,cg,ur
cb,ug,ug,ur,ub,ug,ug,cb,ug,ur,ub,ug,ug,ug,ug,ur,ug,ur,ur,ur,ur,ur,ur
ur,ur,ur,ur,ub,ug,ug,ub,ub,ub,ub,ug,ug,ub,ug,ur,ub,ur,ur,ur,ur,ur,ur
ur,ug,ug,ub,ub,ub,ub,ub,ur,ur,ub,ub,ub,ub,ub,ur,ub,ur,ur,ur,ur,ur,ur
ur,ur,ur,ub,ur,ug,ub,ug,ur,ur,ub,ub,ur,ub,ub,ub,cb,ur,ur,ur,ur,ur,ur
ug,ug,ug,ub,ur,ug,ub,ug,ug,ug,ug,ub,ub,ub,ub,ur,ur,ur,ur,ur,ur,ur,ur
cb,cb,ug,ub,ur,ug,ub,ur,ur,ur,ub,ub,ub,ub,ur,ur,ur,ur,ur,ur,ur,ur,ur
ub,ub,cb,ub,ur,ug,ub,ur,ur,ur,ub,ur,cg,ur,ur,ur,ur,ur,ur,ur,ur,cr,cb
cb,ub,ub,ub,ur,ug,cr,cr,cr,ur,ub,cg,cb,ur,ur,ur,ur,ur,ur,cr,ur,cr,cb