ur,ur,cr,ur,ur,ur,ur,cb,cb,cb,cg,ur,cg,ur,ur,ur,ur,ur,ur,cb,cb,ux,cb
ur,ur,ur,ur,ur,ur,ur,ur,ur,ur,ur,ur,ur,ur,ur,ur,ur,ur,ur,ur,ur,cb,cb
ur,ur,ur,cr,ur,ur,ur,ur,ur,ur,ur,ur,ux,ur,ur,ur,ur,ur,ux,ux,ur,ux,ux
cg,ur,ur,ur,ug,ug,ur,ur,ur,ur,ur,ur,ur,ur,ur,ur,ur,ur,ub,ub,ub,ub,ub
ur,ur,ur,cr,ug,ug,ur,cg,cb,ur,ur,ur,ur,ur,ur,ur,ur,ub,ub,ub,ub,ub,ub
ur,cr,ug,cg,ur,cg,cr,ug,ub,ur,ur,ur,ur,ur,ug,ur,ur,ur,ur,ur,ur,ur,ux
ur,ur,ux,ub,ur,ur,ur,ur,ub,ug,ug,cr,ub,ub,ug,ub,ub,ub,ub,ub,ub,ub,ub
ux,ug,ug,ug,ug,ug,ug,ug,ub,ub,ur,ub,ub,ub,ub,ub,ug,ug,ug,ur,cr,ux,ub
ux,ux,ux,ur,ug,ug,ub,ub,ub,ub,ur,ub,ux,ux,ux,ux,ux,ux,ux,ub,ur,ub,ub
ux,ux,ux,ux,ux,ur,ub,ub,ub,ub,ub,ub,ub,ub,ub,ub,ux,ux,ux,ub,ur,ux,ur
ux,ux,ux,ux,ux,ur,ub,ug,ug,ug,ug,ug,ug,cg,ub,ub,ug,ux,ux,ub,ur,ub,ub
ux,ub,ub,ub,ub,ux,ub,ug,ub,ub,ub,cb,ug,ug,ub,ub,ug,ug,ug,ur,ur,ux,ub
ub,ub,ub,ub,ub,ub,ux,ug,ub,ub,ug,ug,ug,ug,ub,ux,ug,ug,ug,ur,cb,ub,ub
ub,ub,cb,ur,ur,cr,ux,ug,ug,ug,ug,ug,ug,ug,ug,ug,ux,ug,ug,ur,ur,ux,ur
ub,ub,ub,ub,ub,ux,ub,ub,ug,ug,ug,ux,ug,ug,ug,ug,ug,ug,ug,ur,ur,ux,ur
ub,ub,ub,ub,ub,ux,ux,ux,ug,ug,ug,ub,ug,ug,ug,ug,ug,ug,ug,ur,ur,ux,ur
ub,ub,ub,ub,ub,ux,ux,ux,ug,ug,ug,ug,ug,ug,ug,cg,ux,ux,ux,ur,ur,ux,ur
ub,ub,ux,ur,ur,ux,ux,ux,ux,ux,ub,ub,ub,ub,ug,ug,ux,ux,ux,ur,ur,ur,ur
ux,ux,ux,ur,ur,ux,ux,ux,ux,ux,ux,ub,ub,ub,ug,ug,ub,ux,ux,ur,ur,ur,cb
cg,ux,ux,ur,ur,ux,ux,ux,ux,ux,ux,ur,ur,ub,ub,ub,ub,ub,ur,ur,ur,ur,ur
cb,ux,ux,ur,ur,ur,ur,ur,ur,ur,ur,ur,ur,ub,ub,ub,ub,ub,ur,ur,ur,ur,ur
ur,ur,ur,ur,ur,ur,ur,ur,ur,ur,ur,ur,cg,ub,ub,ub,ub,ux,ux,ux,ur,cr,ur
ur,ur,ur,ur,ur,ur,cr,ux,cr,ux,ux,cg,cb,ub,ub,cb,cr,ux,ux,cr,ur,cr,cb