ug,cr,cr,ug,ug,ug,ur,cb,cb,cb,ub,cg,cg,ur,ur,ur,ur,cb,ur,ur,cb,cb,cb
ug,ug,ug,ug,ug,ug,ug,ug,ug,ug,ug,ug,ug,ug,ug,ub,ub,ub,ub,ub,ub,ub,ug
ug,ug,ug,ug,ug,ug,ug,ug,ug,ug,ug,ug,ug,ug,ub,ub,ub,ub,ug,ub,ub,ub,ug
ug,ug,ug,ug,ug,ug,ug,ub,ug,ug,ug,ug,ub,ub,ub,ub,ub,ub,ub,ub,ub,ub,ug
ug,ug,ug,ub,ub,ub,ug,ub,ub,ub,ub,ug,ug,ur,cr,ub,ub,ug,ug,ub,ug,ur,ug
ug,ug,ug,ug,ug,cg,ur,ur,ur,ur,ur,cb,ur,ur,ub,ub,ub,ub,ub,ub,ub,ur,ug
cg,ug,ug,ub,ub,ur,ub,ur,ur,ur,ur,ub,ur,ur,cr,ub,ug,ug,ug,ub,ub,ur,ug
ub,ug,ug,ur,ug,ur,ub,ur,ub,ub,ub,ub,ug,ub,ub,ub,ub,ub,ug,ug,ub,ur,ug
ug,ug,ug,ub,ug,ur,ur,ur,ub,ub,ub,ub,ub,ub,ub,cb,ur,ur,ur,ug,ub,ur,ur
ug,ug,ug,ur,ur,ur,ub,ur,cb,ub,ub,ub,ub,ug,ub,ub,ub,ub,ub,ug,ub,ub,ur
cb,ub,ub,ur,ug,ub,ub,ur,ur,ur,ub,ug,ug,ug,ub,ub,ug,ug,ub,ug,ub,ub,ur
ub,ub,ug,ur,ug,ub,ub,ur,ub,ur,ub,ug,ub,ug,cb,ub,ub,ub,ub,ug,ub,ur,ur
ub,ub,ur,ur,ug,ur,ub,ub,ur,ur,ur,ur,ur,ur,cg,ug,ug,ug,ug,ug,ub,ub,ub
ug,ug,ug,ug,ug,ur,cb,ub,ub,ub,ub,ub,ub,ug,ug,ub,ug,ug,ub,ur,ur,ur,ub
cg,ug,ug,ug,ug,ug,ur,ur,ub,ub,ub,ub,ub,ub,ub,ub,ub,ub,ub,ub,ub,ub,ub
ug,ug,ug,ur,ug,ug,ur,ub,ub,ub,ur,ur,ur,ub,ub,ug,ug,ug,ub,ur,ub,ub,ub
ug,ug,ug,ur,ug,ug,ug,ug,ub,ub,ub,ub,ub,ub,ub,ur,ur,ub,ur,ur,ur,ur,ur
ug,ug,ug,ur,ur,ur,ug,ur,ub,ub,ub,ub,ub,ub,ug,ur,ur,ur,ur,ur,ur,ur,ur
ug,ug,ug,ug,ub,ug,ug,ub,ub,ub,ub,ub,ub,ub,ub,ur,ug,ug,ur,ur,ur,ur,ur
ug,ug,cg,ug,ur,ug,ug,ub,ub,ub,ub,ub,ub,ur,ur,ur,ur,ur,ur,ur,ur,ur,ur
cb,ug,ug,ug,ug,ug,ug,ub,ug,ug,ug,ub,ub,ub,ub,ub,ur,ug,ur,ur,ur,ur,cg
ug,ug,ug,ug,ug,ug,ug,ug,ug,ug,ug,ub,cg,ub,ub,ug,ur,ug,ur,cr,ur,cr,cb
cb,ug,ug,ug,ug,ug,cr,ug,ug,ug,ur,cg,cb,ub,ub,ub,ur,ur,ur,cr,ub,cr,cb