ur,ur,cr,ur,ur,ur,ur,cb,cb,cb,cg,ur,cg,ur,ur,ux,ux,ux,ux,cb,cb,ux,cb
ur,ur,ug,ur,ur,ur,ur,ur,ur,ur,ur,ur,ur,ur,ur,ux,ur,ur,ux,ux,ux,cb,cb
ur,ur,cr,cg,ur,ur,ur,ur,ur,ur,ur,ur,ur,ur,ur,ux,ux,ur,ur,ur,ux,ur,ur
cg,ur,cr,ur,ur,ur,ur,ur,ur,ur,ur,cr,ur,ur,ub,ur,ur,ur,ur,ur,ur,ur,ur
ug,cg,ur,ur,cb,ug,ur,ur,ur,ur,ur,ur,ur,ur,ub,ur,ur,ur,ur,ur,ur,ur,ur
ux,ub,cr,ub,ub,ug,ur,ur,ur,ur,cr,ug,ur,ur,ur,ur,ur,ur,ur,ur,ur,ur,ux
ux,ub,ub,cg,ug,ug,ug,ur,ug,ug,ur,ur,ur,ur,ub,ub,ub,ub,ub,ub,ur,ur,ur
ub,ub,ub,ub,ug,ug,ug,ug,ug,ub,ur,ub,ub,ub,ub,ub,ug,ug,ub,ub,ub,cb,ur
ub,ux,ux,ux,ug,ub,ub,ur,ur,ub,ur,ux,ux,ux,ux,ux,ux,ub,ub,ub,ur,ur,ur
ub,ux,ux,ux,ux,ub,ub,ub,ub,ub,ub,ub,ub,ub,ub,ug,ug,ug,ug,ub,ur,ur,ur
ub,ux,ux,ux,ux,ub,ub,ug,ug,ub,ub,ug,ug,ug,ug,ug,ug,ug,ug,ug,ug,ur,ub
ub,ub,ub,ub,ub,ub,ub,ub,ub,ub,ub,ub,ug,ug,ug,cg,ug,ug,ub,ub,ub,ub,ub
ub,ub,ub,ux,ub,ub,ub,ug,ub,ub,ub,ub,ub,ub,ub,ub,ug,ub,ub,ub,ub,ub,ub
ub,ub,ub,ub,ub,ub,ub,ub,ug,cg,ub,ub,ub,ub,ub,ub,ug,ub,ub,ub,ub,ur,ur
ux,ub,ub,ub,ub,ub,ux,ux,ug,ug,ug,ux,ug,ub,ub,ug,ux,ub,ub,ub,ub,ur,ub
ux,ub,ub,ub,ub,ub,ux,ux,ug,ug,ug,ug,ub,ub,ub,ug,ug,ub,ub,ub,ub,ur,ub
ub,ub,ux,ux,ux,ub,ux,ux,ug,ug,ug,ub,ub,ub,ub,ub,ub,ub,ub,ur,ur,ur,ur
ub,ub,ux,ux,ux,ub,ux,ur,cr,ux,ux,ub,cb,ug,ug,ug,ug,cb,ux,ur,ur,ur,ur
ux,ux,ux,ux,ux,ub,cb,ur,ug,ux,ux,ub,ub,ub,cr,ur,ur,ur,ur,ur,ur,ur,cb
cg,ux,ux,ux,ux,ux,ux,ux,ux,ux,ux,ur,ub,ub,ub,ub,ub,ub,ur,ur,ur,ur,ur
cb,ux,ux,ux,ux,ux,ux,ux,ux,ux,ux,ur,ub,ub,ub,ub,ub,ub,ux,ur,ur,ur,ur
ux,ux,ux,ux,ux,ux,ux,ux,ux,ux,ux,ux,cg,ub,ub,ub,ux,ux,ux,ur,ur,cr,ur
ux,ux,ux,ux,ux,ux,cr,ux,cr,ux,ux,cg,cb,ub,ub,ub,cr,ux,ux,cr,ur,cr,cb