ur,ur,cr,ub,ub,ur,ur,cb,cb,cb,cg,ur,cg,ux,cr,ur,ux,ux,ux,cb,cb,ur,cb
ur,ur,ur,ur,ub,ub,cb,ur,ur,ur,ur,ur,ur,ur,ur,ur,ub,cr,ub,ub,ur,ur,ur
ur,ur,ur,ur,ug,ug,ur,ur,ur,ur,ur,ur,ur,ur,ur,ur,ub,ur,ur,cb,ur,ur,ur
ur,ur,ur,ur,ug,cg,ur,ur,ur,ub,cr,ur,ur,ur,ur,ur,ub,ub,ux,ub,ub,ub,ub
ur,ur,ur,cg,ug,ug,ug,ub,cg,ug,ub,ub,ur,ur,ub,ub,ub,ub,ux,ub,ub,ub,ub
ur,ur,ur,ur,ur,ur,cr,ub,ub,ug,ug,ug,ug,ub,ub,ub,ub,ub,ux,ub,ub,ur,ub
ur,ur,ur,ur,cr,ug,ug,ub,ub,ug,ub,ub,ug,ur,ub,ur,ub,ub,ur,cb,ub,ub,ub
ug,ug,ux,ug,ur,ur,ur,cr,ub,ub,ur,ub,ug,ub,ub,ux,ub,ub,ux,ux,ur,ub,ub
ug,ur,ur,ur,ur,ub,ub,ub,ub,ug,ug,ug,ub,ub,ub,ub,ub,ub,ub,cb,ur,ub,ub
ug,ur,ug,ur,ur,ub,ux,ux,ub,ug,ug,ug,ub,ug,ub,ub,ug,ug,ug,ur,ur,ub,ub
ux,ur,ux,ur,ur,ub,ux,ux,ux,ux,ux,ug,ub,ug,ug,ub,ub,ug,ug,ug,ur,ub,ub
cg,ur,ux,ur,ur,ur,ur,ur,ur,ur,ur,ur,cb,ur,ur,ur,ur,ur,ug,ub,ur,ub,ub
ux,ur,ux,ur,ux,ub,ux,ux,ux,ub,ux,ux,ub,ub,ub,ug,ug,ug,ug,cb,ug,ur,ur
ux,ur,ux,ur,ux,ub,ub,ub,ub,ub,ub,ub,ub,ub,ub,ug,ug,ug,ug,ub,ub,ub,ur
ux,ur,ux,ur,ur,ur,ur,ur,ur,ub,ub,ub,ub,ur,cg,ug,ug,ug,ug,ub,ub,ub,ur
ux,ur,ur,ur,ur,ur,ur,ur,ub,ub,ub,ub,ub,ur,ur,ub,ub,ug,ug,ub,ub,ur,ur
ux,ux,ux,ux,ux,ux,ux,ux,ub,ub,ux,ux,ux,ur,ux,ur,ux,ux,ux,ux,ur,ur,ur
ux,ux,ux,ux,ux,ux,ux,ux,ug,ug,ux,ux,ux,ur,ux,ur,ux,ux,ux,ux,ub,ur,ur
ux,ux,ux,ux,ux,ux,ux,ux,ug,ug,ux,ub,ub,ur,ub,ur,ub,ub,ub,ub,ub,ur,cb
cg,ux,ux,ux,ux,ux,ux,ux,ux,ux,ux,ux,ux,ur,ux,ur,ur,ur,ur,ur,ur,ur,ur
cb,ux,ux,ux,ux,ux,ux,ux,ux,ux,ux,ux,ux,ur,ux,ur,ur,ux,ux,ux,ux,ur,ur
ux,ux,ux,ux,ux,ux,ux,ux,ux,ux,ux,ux,cg,ur,ux,ur,ur,ur,ur,ur,cr,cr,ur
ux,ux,ux,ux,ux,ux,cr,ux,cr,ux,cb,cg,cb,ur,ur,ur,cr,ux,ux,cr,ur,cr,cb