ur,ur,cr,ur,ur,ur,ur,cb,cb,cb,cg,cg,cg,ur,ur,cr,ur,ur,ur,ur,cb,cb,cb
ur,ur,ur,ur,ur,ur,ur,ur,ur,ur,ur,ur,ur,ur,ur,ur,ur,ub,ur,ur,ur,ur,ur
ur,cr,ur,cg,cr,ug,ur,ur,ur,ur,ur,ur,ur,ur,ur,ur,ur,ur,ur,ur,ur,ur,ur
cb,ur,ur,cr,ug,cg,ur,ur,ur,ur,ur,ur,ur,ur,ur,ur,ur,ur,ur,ur,ur,ur,ur
ur,ur,ur,ug,ug,ug,ur,cr,ur,ur,ur,ur,ur,ur,ur,ur,ur,ur,ur,ux,ux,ur,ur
ur,ur,ur,ur,ug,ug,ur,ur,ur,cb,ub,ur,cr,ux,ux,ux,ux,ux,ur,ur,ur,ur,ur
ur,ur,ur,ur,ur,ur,ub,ub,ub,ub,ub,ub,cb,ur,ux,ux,ux,ux,ur,ur,ur,ur,ur
ur,ur,ur,ur,ur,ur,ub,ug,ug,ub,ug,ug,ub,ub,ub,ur,ux,ux,ur,ur,ur,ur,ur
ur,ur,ur,ur,ur,ug,ub,ub,cg,ug,ug,ug,ug,ub,ub,ur,ux,ub,ur,ur,ur,ur,ur
ur,ur,ur,ur,ug,ug,ug,cg,ug,ug,ur,ug,ug,ug,ug,ug,ug,ug,ug,ug,ug,ux,ub
ur,ur,ux,ux,ur,ur,ur,ug,ug,ug,ug,ug,ug,ug,ug,ub,ug,ug,ug,ug,ug,ub,ub
ur,ur,ur,ur,ur,ur,ur,ug,ug,ug,ug,ug,ub,ub,ug,ug,ug,ug,ug,ug,cg,ur,ur
ur,ur,ur,ur,ur,ur,ur,ur,ur,ur,ur,ur,ub,ux,ug,ug,ug,ug,ug,ug,ug,ug,ur
ur,ux,ux,ux,ux,ur,ur,ur,ur,ur,cb,ux,ub,ub,ug,ug,ug,ug,ug,ug,ug,ug,ur
ur,ur,ur,ur,ur,ub,ub,ub,ur,ur,ur,ur,ur,ub,ub,ub,ub,ug,ug,ug,ug,ux,ur
ux,ux,ux,ur,ur,ub,ub,ub,ub,ub,ub,ub,ub,ub,ub,ub,ub,ur,ur,ur,ur,ur,ur
ux,ur,ur,ur,ur,ur,ur,ub,ub,ub,ux,ux,ux,cb,ub,ub,ub,ux,ux,ux,ub,ux,ux
ux,ur,ur,ur,ur,ur,ur,ur,ur,ub,ub,ub,ub,ub,ub,ub,ub,ub,ub,ub,ub,ux,ux
ux,ux,ux,ux,ux,ub,ub,ub,ub,ub,ub,ux,ub,ub,ur,ub,ub,ub,ub,ub,ub,ux,cb
cg,ux,ux,ux,ub,ub,ub,ub,ub,ub,ux,ux,ub,ub,ur,cb,ux,ux,ux,ux,ub,ux,ux
cb,ux,ux,ux,ux,ux,ub,ub,ub,ub,ub,ub,ux,ux,ur,ur,ux,ub,ub,ub,ub,ux,ux
ux,ux,ux,ux,ux,ux,ub,ub,cb,ub,ub,ub,cg,ux,ur,ur,ux,ux,ux,ux,ux,cr,cb
cb,ux,ux,ux,ux,ux,cr,ub,cr,ub,ub,cg,cb,ux,cr,cr,cr,ux,ux,cr,ux,cr,cb