ur,ur,cr,ur,ur,ur,ur,cb,cb,cb,ur,ur,cg,ur,ur,cb,ub,ub,ux,cb,cb,ux,cb
ur,cg,ug,ug,cr,ur,ur,cr,ur,ur,ur,ur,ur,ur,ur,ux,ub,ub,ux,ux,ux,ux,cb
ur,cg,ug,cg,ur,ur,ur,ur,ur,ur,ur,ur,ub,ub,ub,ub,ub,ub,ux,ux,ux,ux,ux
ur,ug,cr,ur,ur,ub,ub,ub,ub,ug,ur,ur,ub,ur,ur,ur,ur,ub,ub,ur,ur,ux,ux
ur,ur,ur,ur,cb,ub,ug,ug,ub,ux,ur,ug,ug,ur,ur,ur,ur,ub,ub,ub,ur,ux,ux
ub,ub,ub,ur,ur,ur,ur,ur,ub,ub,ub,ug,ug,ur,ur,ur,ur,ub,ub,ub,ub,ub,ub
ub,ur,cb,ur,ur,ur,ur,ur,cr,ug,ug,ug,ug,ug,ug,ug,ug,ub,ub,ux,ur,ux,ub
ub,ur,ur,ur,ur,ug,ur,ug,ug,ug,ug,ub,ub,ur,ux,ux,ug,ux,ub,ux,ur,ux,ub
cr,ur,ur,ur,ur,ug,ug,ug,ur,ub,ub,ub,ub,ug,ux,ux,ug,ux,ub,ux,ux,ux,ub
ub,ur,ur,ur,ur,ux,ug,ux,ub,ub,ub,ub,ug,ug,ur,ur,ug,ux,ub,ux,ux,ux,ub
ub,ur,ur,ur,ur,ux,ug,ub,ub,ur,ub,ub,ur,ub,ub,ub,ug,ux,ub,ux,ux,ux,ub
ub,ub,ux,ug,ug,ug,ug,ub,ug,ug,ub,ub,ub,ub,ug,ug,ug,ug,ug,ug,ux,ux,ub
ub,ub,ux,ux,ux,ux,ub,ub,ug,ug,ub,ub,ub,ub,ug,ub,ur,ug,cg,ug,ux,ux,ub
ub,ub,ug,ug,ug,ug,ug,ug,ug,ug,ug,ug,ur,ub,ug,ug,ug,ug,ur,ug,ug,ux,ub
ur,ur,ur,ur,ur,ur,ur,ur,ur,ur,ur,ur,ur,cb,cg,ux,ur,ug,ug,ug,ur,ux,ub
ur,ux,ug,ug,ug,ug,ug,ug,ug,ux,ub,ub,ub,ub,ur,ux,ur,ub,ub,ur,ur,ub,ub
ur,ux,ux,ux,ux,ux,ux,ug,cg,ug,ug,ux,ur,ur,ur,ux,ur,ux,ub,ur,ux,ub,ur
ur,ur,ur,ur,ur,ur,ur,ur,ur,ur,ur,cr,ub,ux,ur,ur,ur,ub,ux,ur,ux,ub,ur
cg,ux,ux,ux,ux,ux,ux,ux,ux,ug,ug,ux,ub,ux,ub,ur,ur,ub,ub,ur,ux,ub,ur
cg,ux,ux,ux,ux,ux,ux,ux,ux,ug,ug,ux,ub,ur,ub,ub,ub,ub,ub,ub,ur,ub,ur
cb,ux,ux,ux,ux,ux,ux,ux,ux,ug,ux,ux,ub,cr,ur,ur,cb,cb,ub,ub,ub,ub,ur
ux,ux,ux,ux,ux,ux,ux,ux,ux,ux,ux,ux,cg,ub,ub,ub,ub,ur,ub,ub,ub,cr,ur
ux,ux,ux,ux,ux,ux,cr,ux,cr,ux,ux,cg,cb,ux,ux,ux,cr,ur,ur,cr,ub,cr,cb