ur,ur,cr,ub,ur,ur,ur,cb,cb,cb,cg,cg,cg,ur,ur,ur,ur,ur,ur,ur,cb,cb,cb
ur,ur,cr,ub,cb,cr,ur,ur,ur,ub,ub,ub,cr,ub,ub,ub,ur,ur,ur,ur,ur,ur,ur
ur,cr,ur,ur,ur,ur,ur,ur,ur,ub,ur,ur,ur,ur,ur,ub,ub,ub,ub,ub,ur,ur,ur
cb,ur,ur,ur,ug,ug,cr,cg,ur,cb,ur,ug,ug,ub,ub,ub,ub,ub,ub,ub,ur,ur,ur
ur,ur,ur,ur,cg,ur,ur,ug,ug,ur,ur,ug,ug,ub,ub,ur,ur,ub,ub,ub,ux,ux,ur
ur,ur,ur,ug,ug,ug,ur,ug,ug,ur,ur,ug,ug,ub,ub,ur,ur,ub,ub,ub,ur,ux,ur
ur,ur,ug,ug,ug,ug,ur,ur,ur,ur,ug,ug,ub,ub,ub,ub,ub,ub,ub,ub,ur,ux,ur
cr,ur,ur,ur,cr,ug,ur,ur,ur,ug,ug,ug,ug,ub,ub,ub,ub,ub,cb,ub,ur,ux,ur
ub,ub,ur,ug,ur,ug,ug,ux,ux,ug,ur,ux,ug,ub,ub,ux,ux,ub,cg,ug,ub,ub,ur
ub,ub,ur,ux,ug,ug,ux,ux,ux,ug,ur,ub,ub,ub,ub,ub,ub,ub,ub,ug,ur,ub,ur
ub,ub,ur,ux,ug,ug,ug,ug,ug,ug,ur,ug,ug,ug,ug,ug,ug,cg,ub,ub,ub,ub,ub
ub,ub,ur,ux,ux,ug,ug,ug,ub,ub,ur,ub,ux,ug,ug,ug,ug,ug,ub,ub,ur,ub,ub
ub,ub,ur,ub,ub,ug,ub,ub,ub,ub,ur,ub,ug,ug,ub,ug,ug,ug,ug,ug,ur,ux,cb
ub,ub,ur,ux,ux,ug,ug,ug,ug,ub,ur,ug,ug,ug,ug,ug,ug,ug,ug,ug,ur,ux,ur
ub,ub,ur,ub,ux,ug,ug,ug,ug,ub,ur,ub,ub,ur,ug,ug,ux,ub,ub,ur,ur,ux,ur
ub,ub,ur,ub,ux,ug,ux,ux,ux,ub,ur,ub,ub,ub,ub,ub,ub,ub,ux,ur,ur,ux,ur
ub,ub,ur,ub,ux,ug,ux,ux,ux,ur,ur,ub,ub,ub,ub,ub,ub,ub,ub,ur,ur,ux,cr
ux,ux,ur,ux,ux,ug,ux,ux,ux,ur,ur,ux,ub,ub,ub,ub,ub,ub,ub,ur,ur,ux,ux
ux,ux,ur,ux,ux,ug,ux,ux,ux,ur,ur,ux,ub,ub,ub,ub,ub,ub,ub,ur,ur,ux,cb
cg,ux,ur,ux,ux,ug,ux,ux,ux,ur,ur,ub,ub,ub,ub,ub,ub,ub,ub,ur,ur,ub,ub
cb,ux,ur,ux,ub,cb,ub,ub,ux,ur,ur,ub,ub,ub,ub,ub,ub,ub,ub,ur,ur,ub,ub
ux,ux,ur,ux,ux,ug,ub,ub,ub,ub,ub,ub,cg,ub,ub,ub,ux,ux,ux,ur,ur,cr,cb
cb,ux,ur,ur,cg,ug,cr,ux,cr,ur,ur,cg,cb,ub,ub,ub,cr,ux,ux,cr,ur,cr,cb