cb,cr,ur,ub,ub,cb,ub,ug,ug,ug,ug,ug,ub,ur,ur,ub,ur,ur,ur,ub,cb,ur,cr
cr,ur,ur,ur,ub,ug,ug,ux,ug,ub,ug,ug,ur,ub,ub,cb,ub,ub,ub,ub,ub,ub,cb
cr,ur,ux,ug,ug,ug,ug,ug,ug,ug,ug,ug,ur,ub,ub,ub,ub,ub,ub,ub,ub,ub,cb
ur,ur,ug,ug,ug,ug,ug,ug,ug,ug,ug,ub,ub,ub,ux,ux,ub,ub,ub,ub,ux,ub,cr
ur,ub,ub,ug,ux,ux,cg,ub,ub,ub,ug,ub,ub,ub,ux,ux,ux,ux,ux,ux,ub,ub,cb
ur,ux,ug,ug,ug,ug,ug,ug,ug,ug,ug,ux,ur,ub,ux,ux,ux,ux,ux,ux,ub,ub,ur
ur,ur,ug,ub,ub,ub,ub,ub,ux,ux,ux,ur,ur,ub,ux,ub,ux,ux,ux,ux,ub,ub,ub
ur,ur,ug,ug,ug,ub,ub,ub,ux,ur,ug,cg,ub,ub,ub,ub,ux,ux,ux,ub,ub,ub,ub
ub,ub,ub,ub,ub,ub,ub,ub,ub,ug,ug,ux,ux,ub,ub,ub,ub,ub,ub,ub,ur,ub,ub
ug,ub,ub,ug,ub,ux,ub,ub,ub,ug,ug,ug,ux,ub,ub,ux,ux,ux,ux,ux,ur,cb,cr
cg,cb,ub,ug,ux,ux,ub,ub,ub,ub,ug,ug,ug,ux,ub,ux,ug,ux,ux,ug,ur,ux,ub
ub,ub,ug,ug,ug,ug,ug,ub,ub,ub,cb,ug,ug,ub,ub,ux,ug,ug,ug,ug,ur,ux,ub
cb,ub,ub,ug,ug,ur,ur,ux,ux,ux,ub,ub,ub,ub,ub,ub,ub,ug,ux,ug,ur,ux,ub
cr,ux,ux,ug,ug,ux,ur,ux,ug,ug,ug,ug,ug,ug,ug,ug,ub,ug,ux,ug,ur,ux,ub
ub,ur,ux,ug,ug,ug,ur,ug,ug,ug,ug,ug,ug,ug,ug,ug,ub,ub,ux,ug,ur,ur,ub
ub,ur,ur,ug,ur,ux,ur,ux,ug,ug,ug,ug,ug,ug,ug,ug,ug,ub,ub,ug,ub,ub,ub
ub,ux,ux,ug,ur,ux,ur,ur,ux,ux,ux,ux,ux,ux,ux,ux,ux,ux,ub,ub,ub,ub,ur
ub,ux,ux,ug,ur,ur,ur,ur,ux,ux,ux,ux,ux,ux,ux,ux,ux,ub,ub,ub,ux,ug,ur
ur,ub,ux,ug,ug,ur,ur,ur,ur,ur,ur,ux,ux,ux,ux,ux,ux,ub,ub,ub,ub,cg,cr
cr,ub,ur,ug,ug,ur,ur,ur,ur,ur,ur,ux,ub,ub,ux,ux,ux,ub,ub,ub,ub,ug,cg
cg,ub,ur,ug,ug,ur,ur,ur,ub,ub,ub,ub,ub,ub,ub,ub,ub,ub,ub,ub,ub,ub,cr
cr,cb,ub,ug,ur,ur,ur,ub,ub,ur,ub,ub,ub,cb,ub,ub,ub,ub,ub,ur,ur,ur,ur
cg,cg,cb,cg,cr,ur,cr,cb,cr,cb,ub,ub,ug,cg,ub,ub,ub,ub,ub,ub,ug,ug,cg