ug,ug,cr,ur,ur,ur,ur,cb,cb,cb,ur,cg,cg,ur,ur,ur,ub,ur,ur,ur,cb,cb,cb
ug,ug,ug,ur,cr,ug,ur,ur,ur,ur,cb,ub,ub,ub,ub,ub,ub,ub,ub,ub,ub,ub,ub
ug,cr,ug,ug,ug,ub,ur,ur,ur,ur,ur,ur,cr,ub,ub,ub,ub,ub,ub,ub,ub,ub,ub
ug,ug,ug,ur,ur,ur,ur,ur,ur,ur,ur,ug,ur,ur,ur,ur,ur,ur,ur,ur,ur,ur,ur
ug,ug,cg,ug,ur,ug,ug,ur,ur,ur,ur,ug,ur,ur,ur,ur,ur,ur,ur,ur,ur,ur,ub
cg,ug,ub,ur,ur,ur,ug,ur,ur,ur,ur,ur,ur,ug,ug,ug,ub,ub,ub,ur,ur,ub,ub
cg,ug,ub,ug,ub,ur,ub,ur,ur,ur,ur,ur,ur,ug,ur,ug,ug,ug,ub,ur,ub,ub,ub
ub,ug,ur,ur,ur,ur,ub,ur,ur,ug,ug,ur,ur,ug,ub,ub,ub,ug,ug,ur,ur,ur,ub
cr,ug,ur,ub,ub,ub,ub,ub,ur,ug,ug,ur,ur,ug,ug,ub,ur,ug,ur,ur,ub,ur,ub
ur,ug,ub,cb,ug,ub,ub,ub,ub,ug,ug,ug,ub,ug,ub,ub,ub,ug,ug,ug,ub,ur,ub
ur,ug,ub,ub,ug,ug,ub,ub,ub,ug,ub,ug,ug,ug,ug,ub,ug,ur,ur,ug,ur,ur,ub
ur,ur,ur,ub,ub,ub,ub,ub,ub,ug,ub,ug,ub,ub,ug,ub,ub,ur,ub,ug,ub,ur,ub
ug,ur,ur,ur,ur,ub,ub,ub,ub,ug,ub,ug,ub,ub,ub,ub,ug,ur,ug,ug,ub,ub,ub
ug,ur,ub,ub,ur,ub,ub,cb,ub,ug,ub,ug,ug,ug,ug,ub,ug,ur,ub,ug,ur,ur,ub
cg,cg,ug,ug,ur,ub,ur,ur,ur,ug,ug,ug,ug,ug,ug,cr,ur,ur,ug,ug,ub,ub,ub
ub,ur,ur,ug,ug,ug,ug,ug,ur,ug,ug,ug,ug,ug,ug,ur,ug,ug,ug,ug,ub,ub,ub
ub,ug,ur,ug,ug,ur,ur,ug,ur,ug,ur,ug,ub,ur,ub,ur,ur,ub,ug,ug,ub,ub,cb
ub,ug,ur,ug,ug,ug,ug,ug,ur,ug,cg,ur,ur,ur,ub,ur,ug,ug,ug,ug,ub,ub,ub
ub,ug,ur,ub,ug,ug,ug,ug,ub,ur,ur,ug,ur,ug,ug,ur,ug,ug,ug,ub,ub,ur,ub
ub,ub,ub,ub,ug,ug,ug,ug,ub,ur,ur,ug,ur,ub,ub,ur,ub,ub,ub,ub,ub,ub,ub
cb,cb,ub,ub,ug,ug,ug,ug,ub,ur,ur,ug,ur,ur,ur,ur,ur,ur,ur,ub,ub,ur,ug
ug,ug,ug,ug,ug,ug,ug,ug,ug,ur,ur,ug,cg,ur,ur,ur,cb,ur,ur,ub,ub,cr,cb
cb,ug,ug,ug,ug,ug,cr,ug,cr,ur,ur,cg,cb,ur,ur,ub,ub,ub,ub,cr,ub,cr,cb