ug,ug,cr,ur,ur,ur,ur,cb,cb,cb,ur,cg,cg,ur,ur,ur,ur,ur,ur,ur,cb,cb,cb
ug,ug,ug,ug,ur,ur,ur,ur,ur,ur,ur,ur,cg,ur,cr,ug,cg,ur,ur,ur,ur,ur,ur
ug,cr,cb,ug,ur,ur,ur,ur,ur,ur,ur,ur,ur,ur,ur,ur,ur,ur,ur,ur,ur,ur,ur
ug,ur,ur,ug,ur,ur,ur,ur,ur,ur,ur,ur,ur,ur,ur,ur,ur,ur,ur,ur,ur,ur,ur
ug,ur,ur,ug,ur,ur,ur,ur,ur,ur,ur,ur,ur,ur,ur,ur,ur,ur,ur,ur,ur,ur,ur
ug,ur,ur,ug,ur,ur,ur,ur,ur,ur,ur,ur,ur,ur,ur,ur,ur,ur,ur,ur,ur,ur,ur
ug,ur,ur,ug,ur,ur,ur,ur,ur,ur,ur,ur,ur,ur,ur,ur,ur,ur,ur,ur,ur,ur,ur
cr,ur,ur,ug,ur,ur,ur,ur,ur,ub,ub,ur,ur,ug,ur,ur,ur,ur,ur,ur,ur,ur,cb
ur,ur,ur,ug,ur,ur,ur,ur,cg,ub,ur,ur,ur,ur,ur,ur,ur,ur,ur,ur,ur,ur,ur
ug,ur,ur,ug,ur,ur,ur,ur,ur,cb,ub,ur,ur,ur,ur,ug,cr,ur,ur,ur,ur,ur,ur
ug,ur,ur,ug,ur,ur,ur,ur,ur,ur,ur,ur,ur,ur,ur,ug,ur,ur,ur,ur,ur,ur,ur
ug,ur,ur,cg,ur,ur,ur,ur,ur,ur,ur,ur,cr,ur,ur,ug,ur,ur,ur,ur,ur,ur,ur
ub,ur,ur,ur,ur,ur,ur,ur,ur,ur,ur,ug,ug,cg,ug,ug,ur,ur,ur,ur,ur,ur,ur
cb,ur,ub,ur,ur,ur,ur,ur,ur,ur,ug,ug,cr,ug,ug,ug,ur,ur,ur,ur,ur,ur,ur
ub,ub,ub,ur,ur,ur,ur,ur,ur,ur,ur,ur,ur,ur,ub,ub,ub,ub,cb,ur,ur,ur,ur
ur,ub,ub,ub,ur,ur,ur,ur,ur,ur,ur,ug,ug,ur,ur,ur,ur,ur,ur,ur,ur,ur,ur
ur,ub,ur,ur,ur,ur,ur,ur,ur,ur,ur,ug,ug,ur,ur,ur,ur,ur,ur,ur,ur,ur,ur
ur,ub,ub,ur,ur,ur,ur,cb,ub,ur,ur,ur,ur,ur,ur,ur,ur,ur,ur,ur,ur,ur,ur
ur,ur,ur,ur,ub,ur,ur,ub,ub,ur,ur,ur,ur,ur,ur,ur,ur,ur,ur,ur,ur,ur,ur
cg,ur,ur,ur,ur,ub,cr,ub,ub,ur,ur,ur,ur,ur,ur,ur,ur,ur,ur,ur,ur,ur,ur
cb,ur,ur,ub,ub,ur,ur,ub,ub,cb,ub,ur,ur,ur,ur,ur,ur,ur,ur,ur,ur,ur,ur
ug,ug,ug,ug,cr,ur,ub,ub,ub,ub,ur,ur,cg,ur,ur,ur,ur,ur,ur,ur,ur,cr,cb
cb,ug,ug,ur,ur,ur,cr,cb,cr,ub,ub,cg,cb,ur,ur,ur,ur,ur,ur,cr,ur,cr,cb