ur,ur,cr,ur,ur,ur,ur,cb,cb,cb,cg,ur,cg,ur,ur,ux,ux,ux,ur,cb,cb,ur,cb
ur,ur,ur,ur,ur,ur,ur,ur,ux,ux,ur,ur,ub,ub,ub,ub,ub,ub,ub,ub,ub,cb,ur
ur,ur,ur,ur,ur,ur,ur,ur,ux,ux,ur,ur,ub,ub,ub,ub,ub,ub,ux,ux,ux,ux,cr
cg,ur,ug,ur,cg,cr,cr,ur,ux,ux,ur,ux,ux,ub,ub,ub,ur,ux,ux,ux,ux,ux,ux
ur,ug,cg,ur,ur,ur,ur,ur,ur,ur,ur,ur,ux,ux,ux,ub,ur,ux,ux,ux,ux,ux,ux
ur,cr,ur,ur,ug,cr,ur,ur,ux,ux,ur,ur,ub,ub,ub,ub,ur,ur,ux,ux,ux,ux,ux
ur,ur,ub,cb,ur,ur,ur,ur,ub,ur,ur,ux,ub,ux,ux,ux,ug,ug,ux,ux,ux,ux,ux
ur,ub,ub,ug,ur,ur,ur,ur,ub,ug,ug,ub,ub,ux,ux,ug,ug,ug,ux,ux,ux,ux,ux
ur,ub,ub,ug,ur,ur,ur,ug,ug,ux,ur,ug,ug,ug,ug,ug,ug,ug,ux,ux,ux,ux,ux
ur,ur,ub,ug,ub,ur,ur,ub,ub,ub,cg,ug,ur,ug,ug,ug,ug,ug,ug,ug,ug,ug,ug
ur,ur,ur,ug,cg,ur,ux,ub,ub,ub,ur,ug,ur,ug,ug,ug,ug,ug,ux,ux,ux,ux,ug
cg,ub,ub,ub,ub,ux,ug,ug,ub,ub,ub,ub,ur,ug,ug,ug,ug,ug,ux,ux,ux,ux,ug
ux,ub,ux,ub,ub,ux,cb,ug,ub,ub,cb,ub,ur,ug,ug,ug,ug,ug,ug,ug,ug,ug,ug
ux,ub,ux,ux,ux,ux,ub,ug,ux,ub,cb,ug,ur,ug,ug,ug,ur,ur,ur,ub,ub,ub,ur
ux,ub,ux,ux,ux,ux,ub,ug,ub,ub,ub,ug,ur,ug,ub,ug,ux,ux,ux,cb,ub,ub,ub
ux,ub,ux,ub,ub,ur,ub,ug,ub,ub,ub,ub,ur,ug,ug,ug,ux,ux,ux,ub,ub,ub,ub
ux,ub,ux,ub,ub,ub,ub,ur,ur,ub,ub,ub,ur,ub,ug,ug,ux,ux,ux,ub,ub,ub,ur
ux,ub,ux,ub,ux,ub,ub,ur,ur,ub,ub,ub,ur,ux,ux,ug,ux,ux,ux,ux,ub,ur,ur
ux,ub,ub,cr,ur,ur,ur,ur,ur,ur,ub,ub,ur,ux,ux,ug,ux,ux,ux,ub,ub,ub,cb
cg,ur,ur,ur,ub,ub,ub,ur,ur,ur,ug,ub,ur,ur,ur,ur,ur,ur,ur,ur,ur,ur,ur
cb,ur,ub,ub,ub,cb,ub,ur,ur,ur,ub,ub,ux,ux,ux,cr,ur,ur,ur,ur,ur,ur,ur
ub,ub,ub,ub,ub,ub,ur,ur,ur,ur,ub,ub,cg,ux,ux,ux,ux,ux,ux,ux,ux,cr,ux
ub,ub,ub,ub,ub,ub,cr,ur,cr,ur,ur,cg,cb,ux,ux,ux,cr,ux,ux,cr,ux,cr,cb