ur,ur,cr,ur,ur,ur,ur,cb,cb,cb,cg,cg,cg,cb,ur,ur,ur,ur,ur,ur,cb,cb,cb
ur,ur,ur,ur,ur,ur,ur,cg,ur,ur,ur,ur,ur,ur,ur,ur,ur,ur,ur,ur,ur,ur,ub
ur,cr,ur,ur,ur,ur,ur,ur,ur,ur,ur,ur,ur,ur,ur,ur,ur,ur,ur,ur,ub,ub,ub
cb,ur,ur,ur,ur,ur,ur,ur,ur,ur,ur,ur,ur,ur,ur,ur,ur,ur,ub,cb,ub,ur,ur
ur,ur,ur,ur,ur,ur,ur,ur,ur,ur,ur,ur,ur,ur,ur,ur,ur,ur,ub,ub,ub,ur,ur
ur,ur,ur,ur,ur,ur,ur,ur,ur,ur,ur,ur,ur,cr,ug,ug,ug,ug,cg,ur,ur,ur,ur
ur,ur,ur,ur,cr,ug,ur,ur,ur,ur,ur,ur,ur,ug,ug,ug,ug,ur,ub,ub,ur,ur,ur
ur,ur,ur,ur,ur,ug,ub,ub,ub,ub,ub,ub,ub,ux,ur,ur,ug,ug,ub,cr,ur,ur,ur
ur,ur,cr,ux,ux,ug,ub,ub,ub,ub,ub,ub,ub,cb,ur,ur,ur,ug,ux,ug,ur,ur,ur
ur,cr,ux,ux,ub,ub,ug,ub,ur,ur,ug,ub,ug,ug,ur,ur,cg,ug,ug,ug,ur,ur,ur
ux,ux,ur,ur,ub,ub,ub,ub,ur,ur,ur,ur,ur,ur,ur,ur,ur,ux,ub,ug,ur,ur,ug
ux,ux,ug,ug,ub,ub,ub,ug,ug,ug,ug,ur,ug,ug,ur,ur,ur,ur,ur,ur,ub,ur,ur
ur,ur,ug,ug,ug,ug,ug,ug,ur,ub,ur,ur,ug,ur,ub,ub,ux,ux,ub,ur,ub,ux,ur
ub,ug,ug,ug,ug,ug,ub,cg,ur,ug,cb,ur,ug,ug,ug,ux,ux,ux,ub,ur,ux,ux,ur
ub,ug,ub,ug,ux,ug,ub,ug,ug,ug,ug,ur,ug,ug,ug,ux,ux,ux,ub,ur,ux,ux,ur
ub,ux,ub,ug,ug,ug,ub,ug,ug,ug,ub,ur,ur,ug,ug,ug,ug,ug,ux,ur,ux,ux,ur
ub,ux,ub,ux,ux,ux,ub,cg,ug,ug,ug,cr,ub,ub,ux,ux,ux,ug,ux,ur,ux,ux,ur
ub,ub,ub,ub,ub,ub,ub,ub,ug,ug,ug,ug,ug,ug,ug,ug,ug,ug,ux,ur,ur,ur,ur
ub,ub,ub,ux,ux,ux,ux,ux,ur,ur,ur,ux,ux,ux,ux,ux,ux,ur,ux,ux,ux,ux,cb
cg,ux,ux,ux,ux,ux,ux,ux,ur,ur,ur,ux,ux,ux,ux,ux,ux,ux,ux,ux,ux,ux,ux
cb,ux,ux,ux,ux,ux,ux,ux,ur,ur,ur,ux,ux,ux,ux,ux,ux,ux,ux,ux,ux,ux,ux
cr,ur,ur,ur,ur,ur,ur,ur,ur,ur,ur,ux,cg,ux,ux,ux,cb,ux,ux,ux,ux,cr,cb
cb,ux,ux,ux,ux,ux,cr,cb,cr,ur,ur,cg,cb,ux,ux,ux,cr,ux,ux,cr,ux,cr,cb