ur,ur,cr,ur,ur,ur,cr,cb,cb,cb,ur,cg,cg,ur,ur,ur,ur,ur,ur,ur,cb,cb,cb
ur,ur,cb,ur,ur,ug,ur,ur,ur,ur,ur,ur,ur,ur,ur,ur,ur,ur,ur,ur,ur,ur,ur
ur,cr,cb,ur,ur,ur,ur,ur,ur,ur,ur,ur,ur,ur,ur,ur,ur,ur,ur,ur,ur,ur,ur
ur,ur,ur,ur,ur,ur,ur,ur,ur,ur,ur,ur,ur,ur,ur,ur,ur,ur,ur,ur,ur,ur,ur
ur,ur,ur,ug,ur,ur,ur,ur,ur,ur,ur,ug,cr,ug,ug,ug,ug,ug,ur,ur,ur,ur,ur
cb,ur,ur,cr,ur,ur,ur,ur,ur,ur,ug,ug,ur,ur,ur,ur,ur,ug,cg,ur,ur,ur,ur
ur,ur,ur,ug,ur,ur,ur,ur,ur,ur,ug,ug,ur,ur,ur,ur,ur,ug,ur,ur,ur,ur,ur
ur,ur,ub,ug,ur,ur,ur,ur,ur,ur,cg,ur,ur,cr,ug,ur,ur,ug,ug,ur,ur,ur,ur
ur,ur,ub,ug,ur,ur,ur,ur,cg,ur,ur,ur,ur,ug,ug,ug,ug,ug,ug,ur,ur,ur,ur
ur,ur,ur,ug,ur,ur,ur,ur,ur,ur,ub,ub,ur,ub,ub,ub,ur,ug,ug,ur,ur,ur,ur
cb,ur,ub,ug,ur,ur,ur,ur,ur,ur,ub,ur,ur,ur,ub,ub,ur,ug,ug,ug,ug,ug,ur
ub,ur,ub,ug,ub,ur,cg,ur,ur,ur,ub,cb,ur,ur,ub,ur,ur,ur,ug,ug,ur,ug,ur
ur,ur,ur,ug,ur,ur,ug,ug,ug,cr,ur,ur,ur,ur,ub,ub,ug,ur,ur,ur,ur,ur,ur
ur,ur,ur,cg,ur,ur,ur,ur,ur,ur,ur,ur,ur,ur,ub,ur,ur,ur,ug,ur,ur,ur,ur
ur,ur,ur,ub,ub,ur,ur,ur,ur,ur,ur,ur,ur,ug,ub,ur,ug,ur,ug,ur,ug,ur,ur
ur,ur,ur,ub,ur,ur,ur,ur,ur,ur,ug,ug,ug,ug,ur,ur,ug,ug,ug,ur,ur,ug,ur
ur,ur,ur,ur,ur,ur,ur,ur,ur,ug,cr,ur,ur,ur,ur,ug,ur,ur,ur,ur,ur,ug,ur
ur,ur,ur,ur,ur,ur,ur,ur,ur,ug,ur,ug,ur,ur,ug,ug,ur,ub,ub,ub,ur,ug,ug
ur,ur,ur,ur,ur,ur,ur,ur,ur,ur,ur,ur,ur,ur,ug,ur,ur,ub,ub,ug,ur,ug,ur
cg,ur,ur,ur,ur,ur,ur,ur,ur,ur,ub,ur,ug,ur,ug,ur,ur,ub,ub,cb,ur,ub,ur
cb,ur,ur,ur,ur,ur,ur,ur,ur,ur,ur,ur,ug,ur,ug,ug,ug,ub,ub,ug,ug,ur,ur
ug,ur,ur,ur,ur,ur,ug,ug,ur,ur,ur,ur,cg,ur,cr,ug,ub,ub,ub,ug,ub,cr,cb
cb,ug,cg,ur,ur,ur,cr,cb,cr,ur,ur,cg,cb,ur,ur,ur,ub,ub,ub,cr,cb,cr,cb