ux,ux,cr,ur,ur,ur,ur,cb,cb,cb,cg,cg,cg,ur,ur,ur,ur,ur,ur,ur,cb,cb,cb
ux,ur,cr,ug,cg,ur,ur,ur,ur,ur,ur,ur,ur,ur,ur,ur,ur,ur,ur,ur,ur,ur,ur
ux,cr,ur,ug,ur,ur,ur,ur,ur,ur,ux,ux,ur,ur,ur,ur,ur,ur,ur,ur,ur,ur,ur
cb,ur,ur,ur,cr,ur,ur,ur,ur,ur,ur,ur,ur,ur,ur,ur,ur,ur,ur,ur,ur,ur,ur
ur,ug,ur,ug,cg,ur,ur,ur,ur,ur,ur,ur,ur,ur,ur,ur,ur,ur,ur,ur,ur,ur,ur
ur,ug,ur,ug,ur,ug,ur,ur,ur,ur,ur,ur,ur,ur,ur,ur,ux,cr,ux,ux,cr,ur,ub
ur,ug,ur,ur,ur,ur,ur,ur,ur,ur,ub,ug,ug,ug,ug,ur,ux,ux,ux,ux,cr,ur,ub
ur,ug,ug,ug,ug,ur,ur,ur,ur,ur,ub,ur,ur,ug,ug,ug,ux,ub,ub,ux,ux,ur,ub
ur,ug,ug,ug,ub,ur,ur,ur,ur,ur,ub,ur,ug,ug,ug,ug,ug,ug,ug,ug,ux,ur,ub
ur,ur,ur,ug,ub,ub,ur,cr,ur,ur,ub,cb,ug,cg,ug,ug,ub,ub,ub,ux,ux,ur,ub
ur,ur,ur,ug,ug,ub,ub,ub,ug,ug,ub,ub,ug,ux,ub,ux,ug,ug,ub,ug,ux,ur,ub
ur,ur,ur,ub,ub,ub,ub,ub,ub,ug,ub,ub,ug,ug,ug,ug,ug,ug,ub,ug,ux,ur,ub
ux,ux,ur,ub,ub,ub,ub,ub,ub,ub,ub,ub,ug,ug,ug,ug,ug,cg,ug,ug,ug,ur,ub
ux,ux,ug,ux,ub,ub,ux,ub,ub,ug,ug,ug,ub,ub,ug,ug,ug,ug,ug,ur,ur,ur,ub
ux,ux,ur,ur,ub,ur,ur,ur,ub,ub,ub,ub,ug,ub,ub,ur,ub,ub,ux,ur,cr,ur,ub
ux,ux,ur,ux,ub,ub,ux,ux,ub,ub,ur,ux,ub,ub,ub,ub,ub,ub,ux,ur,ux,ur,ub
ux,ux,ur,ux,ub,ub,ux,ux,ub,ub,ur,ux,ub,ub,ub,ub,ub,ub,ux,ur,ux,ur,ub
ux,ux,ur,ux,ub,ub,ux,ux,ub,ub,ur,ub,ub,ub,ub,cb,ub,ub,ub,ur,ub,ur,ub
ux,ux,ur,ux,ub,ub,ux,ux,ub,ub,ur,ub,ub,ub,ub,cb,ub,ux,ub,ub,ub,ur,cb
cg,ux,ur,ux,ux,ur,ux,ux,ub,ub,ur,ub,ux,ux,cg,ug,ur,ur,cb,ur,ub,ur,ur
cb,ux,ur,ux,ub,ur,ub,ub,ux,ur,ur,ub,ub,ub,ub,ub,ub,ub,ub,ub,ub,ub,ub
ux,ug,ur,ux,ub,ur,ub,cb,ux,ur,ur,ur,cg,ux,ux,ux,ux,ux,ux,ux,ub,cr,cb
cb,ug,ur,ur,ur,ur,cr,ub,cr,ur,ur,cg,cb,ux,ux,ux,cr,ux,ux,cr,ub,cr,cb