ur,cr,cr,ub,ub,ub,cb,cb,cb,cb,cg,ux,cg,ux,ux,ur,ur,ur,ur,cb,cb,ur,cb
ur,ug,ug,ug,ur,ur,ur,ur,ur,ux,ux,ur,ur,ur,ur,ur,ur,ur,ur,ur,cb,ur,ur
cr,ur,cg,ur,ur,ur,ur,ur,ur,ux,ux,ur,ur,ur,ur,ur,ur,ur,ur,ub,ub,ub,ur
cg,ur,cr,ug,ug,ur,ur,ub,ur,ur,ur,ur,ur,ux,ur,ur,ur,ur,ub,ub,ub,ur,ux
ur,ur,ur,ur,ug,ur,ur,ur,ur,ur,ur,ur,ur,ur,ur,ub,ub,ux,ux,ub,ub,ur,ux
ur,ur,ur,ur,cg,ug,ur,ub,ux,ux,ur,ur,ur,ux,ux,ux,ux,ub,ub,ub,ur,ur,ux
ur,ur,ur,ur,cr,ub,ub,ub,ub,ub,ub,ub,ub,ub,ug,ux,ux,ub,ur,ux,ux,ux,ux
ur,ur,ur,ur,cb,cb,ur,cr,ub,ub,ux,ub,ux,ub,ug,ux,ub,ub,ub,ux,ub,ub,ux
ur,ur,ur,ur,ub,ub,ux,ub,ub,ub,ux,ub,ux,ub,ug,ug,cr,ub,ub,ub,ub,ub,ux
ur,ur,ur,ur,ub,ub,ux,ub,ub,ub,ux,ub,ux,ub,ug,ug,ur,ug,ug,ug,ug,ub,ub
ur,ur,ur,ux,ux,ug,ux,ub,ub,ub,ub,ub,ub,cb,ug,ug,ur,ug,ug,ub,ug,ub,ub
ug,ug,ug,ug,ug,ug,cg,ug,ug,ub,ub,ub,ub,ub,ug,ug,ur,ug,ug,ug,ug,ur,ur
ub,ur,ub,ub,ub,ug,ug,ug,cg,ub,ub,ub,ub,ug,ug,ug,ur,ug,ug,ug,ux,ux,ur
ub,ur,ug,ug,ug,ug,ug,ug,ub,ub,ub,ub,ub,ug,ug,ug,ur,ug,ug,ug,ux,ux,ur
ub,ur,ug,ug,ub,ux,ux,ug,ub,ub,ub,ub,ub,ug,ug,ug,ur,ur,ur,ur,ur,ur,ur
ub,ur,ur,ur,ur,ur,ur,ur,ur,ur,ur,ur,ur,ur,ug,ur,ur,ur,ur,ur,ur,ur,ur
ub,ub,ub,ub,ub,ub,ub,ub,ub,ub,ub,ub,ug,ub,ug,cg,ub,ub,ub,cb,ux,ur,ux
ub,ub,ub,ub,ub,ub,ub,ub,ub,ub,ub,ub,ub,ub,ur,ux,ux,ux,ux,ur,ux,ur,ux
cb,ux,ux,ux,ux,ux,ux,ux,ux,ur,ub,ub,ux,ug,ur,ur,ur,ur,ur,ur,ur,ur,cb
cg,ux,ux,ux,ux,ux,ux,ux,ux,ur,ub,ub,ux,ux,ux,ux,ux,ux,ux,ur,ux,ux,ux
cb,ux,ux,ux,ux,ux,ux,ux,ux,ur,ur,ux,ux,ux,ux,ux,ux,ux,ux,cr,ux,ux,ux
ux,ux,ux,ux,ux,ux,ux,ux,ux,ur,ur,ux,cg,ux,ux,ux,ux,ux,ux,ux,ux,cr,ux
ux,ux,ux,ux,ux,ux,cr,ux,cr,ur,ur,cg,cb,ux,ux,ux,cr,ux,ux,cr,ux,cr,cb