ur,ur,cr,ur,ur,ur,ur,cb,cb,cb,cg,ux,cg,ur,ur,ur,ur,ur,ub,cb,cb,ux,cb
ur,ur,ur,ur,ur,ur,ur,ur,ur,ur,ub,ux,ux,ur,ux,ur,ur,ur,ub,ub,ux,ux,ux
ur,ug,cg,cr,ur,ur,ur,ur,ur,ur,ub,ux,ux,ur,ux,ur,ur,ur,ub,ub,ub,ub,ux
cg,ur,cb,ub,cr,ur,ur,ur,ur,ur,ur,ur,ur,ur,ur,ur,ur,cr,ug,ub,ub,ub,ub
ur,cr,ug,ug,ug,ug,ug,ug,ug,ur,ur,ur,ub,ub,ur,ub,ur,ux,ug,ub,ub,ux,ub
ux,ur,ur,ug,ug,ur,ug,ug,ug,cg,ug,ug,ub,ug,ur,ur,ur,ub,ug,ub,ub,ux,ub
ur,ur,ur,ug,ug,ug,ug,ur,ur,ur,ur,ur,ub,ub,ub,ub,ur,ub,ub,ub,ub,ub,ur
ur,ur,ur,ug,ug,ur,ur,ur,ur,ur,ur,ur,ub,ub,ub,ub,ur,ub,ub,ub,ub,ub,ur
ur,ur,ur,ug,ub,ub,ub,ub,ur,ur,ur,ur,ur,ur,ur,ub,ur,ur,ug,ug,ug,ur,ur
ur,ug,ub,ug,ug,ug,ug,ub,ur,ur,ur,ur,ur,ur,ur,ur,ur,ub,ug,ub,ug,ub,ur
ur,cr,ux,ug,ug,ub,ux,ub,ub,ux,ux,ux,ub,cb,ug,ug,ug,ub,ub,ub,ug,ux,ur
cg,ug,ug,ub,ub,ub,ug,ub,ub,ug,ug,ug,ub,ub,ug,ub,cg,ub,ub,ub,ug,ur,ur
ux,cg,ub,ub,ub,ub,cb,ub,ub,ug,ug,ux,ub,ub,ub,ug,ug,ub,ub,ub,ub,ub,ub
ux,ux,ub,ub,ub,ub,ub,ub,ug,ug,ug,ux,ug,ub,ub,ug,ug,ug,ub,ub,ub,ub,ub
ux,ux,ub,ub,ug,ug,ub,ub,cb,ug,ug,ug,ug,ux,ug,ug,ug,ug,ub,ub,ub,ux,ub
ux,ur,ur,ur,ur,ug,ub,ub,ub,ux,ux,ux,ub,ux,ux,ux,ub,ug,ug,ux,ub,ub,ub
ux,ur,ux,ug,ur,ux,ux,ur,ub,ux,ux,ux,ub,ub,ub,ub,ub,ux,ux,ux,ur,ux,cb
ux,ur,ux,ux,ur,ux,ux,ur,ub,ux,ux,ux,ux,ux,ux,ux,ub,ux,ux,ux,ur,cr,ur
ux,ur,ux,ux,ub,ub,ub,ub,ub,ux,ux,ux,ux,ux,ux,ux,ub,ux,ux,ux,ur,ux,cb
cg,ur,cr,ur,ub,ur,ux,ur,ub,ux,ux,ux,ux,ux,ux,ux,ub,ux,ux,ux,ur,ux,ux
cb,ur,ur,ur,ub,ub,ub,ur,ub,ub,ub,ub,ub,ub,ub,ub,ub,ux,ux,ux,ur,ux,ux
ur,ur,ur,ur,ub,ur,ur,ur,cb,ux,ux,ux,cg,ux,ux,ux,ux,ur,ur,ur,ur,cr,ux
ur,ur,ur,ub,ub,ux,cr,ux,cr,ux,cb,cg,cb,ux,ux,ux,cr,ux,ux,cr,ur,cr,cb