ur,ur,cr,cg,ug,ur,ur,cb,cb,cb,cg,ur,cg,ur,ur,ur,ur,ur,ur,cb,cb,ux,cb
ur,ur,ur,ur,ug,ur,ur,ur,ur,ur,ur,ur,ur,ur,ur,ur,ur,ur,ur,ur,ur,cb,cb
ur,ur,cr,cr,cr,ur,ur,cr,ur,ur,ur,ur,ur,ur,ur,ur,ur,ur,ux,ux,ur,ux,ux
cg,ur,ur,ur,ur,ur,ur,ub,cg,ug,ug,cr,ug,ub,ur,ur,ur,ur,ub,ub,ub,ub,ub
ur,ur,ur,ur,ur,cg,ub,ub,ux,ur,ur,ur,ug,ub,ur,ur,ur,ub,ub,ub,ub,ub,ub
ur,ur,ur,ur,ur,ug,ub,ub,ub,ub,ur,cb,ub,ub,ug,ur,ur,ur,ur,ur,ur,ur,ux
ur,ur,ur,ub,ur,ur,ub,ub,ub,ub,cb,ur,ub,ub,ug,ug,ug,ug,ug,ug,ug,ur,ux
ux,ug,ug,ug,ug,ug,ur,ur,ur,ur,ur,ur,ur,ux,ux,ux,ug,ug,ug,cr,ug,ur,ux
ux,ur,ur,ur,ug,ug,ug,ub,ub,ur,ur,ub,ux,ux,ux,ux,ux,ux,ux,ur,ub,ub,ux
ux,ur,ur,ug,ur,ur,ur,ur,ur,ur,ub,ub,ub,ub,cb,ub,ux,ub,ub,ur,ub,ub,ux
ux,ur,ur,ur,ur,ur,ur,ur,ur,ur,ub,ur,ub,ub,ug,ub,ug,ug,ug,ur,ur,ub,ux
ux,ux,ux,ux,ux,ux,ur,ur,ur,ub,ub,ur,ug,ug,ub,ub,ug,ug,ug,ur,ur,ux,ux
ub,ub,ub,ub,ub,ub,ur,ub,ug,ub,ub,ug,ug,ug,ub,ug,ug,ug,ug,ur,ur,ux,ux
ub,ub,ub,ub,ub,ub,ur,ub,ug,ub,ub,ug,cg,ug,ug,ug,ug,ug,ug,ur,ur,ux,ux
ub,cb,ub,ub,ub,ux,ub,ub,ub,ub,ub,ux,ug,ug,ug,ug,ug,ug,ug,ur,ur,ux,ux
ub,ur,ur,cr,ub,ur,ur,ux,ux,ub,ug,ub,ug,ug,ug,ug,ug,ug,ug,ur,ur,ux,ux
ub,ub,ub,ub,ub,ux,ux,ux,ux,ub,cg,ug,ug,ug,ug,ux,ur,ub,ur,ur,ur,ux,ux
ub,ub,ux,ur,ur,ux,ux,ux,ux,ux,ub,ub,ub,ub,ux,ux,ub,ub,ux,ur,ux,ux,ux
ux,ux,ux,ur,ur,ux,ux,ux,ux,ux,ux,ub,ub,ub,ux,ux,ub,ub,ux,ur,ur,ur,cb
cg,ux,ux,ur,ur,ux,ux,ux,ux,ux,ux,ur,ur,ub,ub,ub,ur,ur,ur,ur,ur,ur,ur
cb,ux,ux,ur,ur,ur,ur,ur,ur,ur,ur,ur,ur,ub,ur,ub,ur,ur,ur,ur,ur,ur,ur
ur,ur,ur,ur,ur,ur,ur,ur,ur,ur,ur,ur,cg,ux,ub,ub,ub,ur,ur,ur,ur,cr,ur
ur,ur,ur,ur,ur,ur,cr,ux,cr,ux,ux,cg,cb,ux,ux,cb,cr,ux,ux,cr,ur,cr,cb