ur,ur,cr,ur,ur,ur,ur,cb,cb,cb,cg,cg,cg,ur,ur,ur,ur,ur,ur,ur,cb,cb,cb
ur,ur,ur,ur,ur,ur,ur,ur,ur,ur,ur,ur,ur,ur,ur,ur,ur,ur,ur,ur,ur,ur,ur
ur,cr,ur,ur,ur,ur,ur,ur,ur,ur,ur,ur,ur,ur,ur,ur,ur,ur,ur,ur,ur,ur,ur
cb,cr,ur,ur,ur,ur,ur,ur,ug,ug,ur,ur,ur,ur,ur,ur,ur,ur,ur,ur,ur,ur,ur
ur,ur,ur,ur,cg,ug,ub,ub,ug,cr,ur,ur,ug,ug,ug,ug,cg,ub,ur,ur,ur,ur,ur
ur,ur,cr,ug,cg,ug,ub,ub,ug,ub,ub,ur,ur,ur,ur,ur,ur,ub,ur,ur,ur,ur,ur
ur,ur,cr,ug,ur,ur,ug,ug,ug,ub,ub,ub,ur,ur,ur,ur,ur,ub,ur,ur,ur,ur,ur
ur,ur,ur,ur,ur,ur,ug,ug,ug,ub,ub,ug,ur,cr,ur,ug,ug,cb,ug,cr,ug,ur,ur
ur,ur,ur,ur,ur,ug,ug,cg,ug,ub,ug,ug,ug,ur,ub,ug,ug,ug,ug,ur,cg,ur,ur
ur,ur,ur,ur,ug,ug,ug,ug,ug,ub,ug,ug,ug,ur,ug,ug,ug,ug,ug,ug,ug,ug,ub
ur,ur,ux,ux,ur,ur,ug,ug,ug,ub,ub,ug,ug,ur,cr,ub,ug,ug,ug,ug,ug,ug,ub
ur,ur,ur,ur,ur,ur,ug,ug,ug,ub,cb,ug,ub,ur,ur,ug,ug,ug,ug,ug,ug,ug,ur
ur,ur,ur,ur,ur,ur,ur,ur,ur,ur,ur,ur,ub,ur,cb,ug,ux,ug,ug,ug,ug,ug,ur
ux,ux,ux,ux,ux,ur,ur,ur,ur,ur,ub,ux,ub,ur,ub,ug,ug,ux,ux,ug,ug,ug,ur
ux,ux,ux,ur,ur,ub,ub,ub,ux,ux,ux,ux,ux,ur,ub,ub,ub,ug,ug,ug,ug,ux,ur
ux,ux,ux,ur,ur,ub,ub,ub,ub,ub,ub,ub,ub,ur,ub,ub,ub,ur,ur,ur,ur,ur,ur
ux,ur,ur,ur,ur,ur,ur,ub,ub,ub,cb,ub,ub,ub,ub,ur,ur,ur,ur,ux,ub,ux,ux
ux,ur,ux,ux,ux,ux,ux,ux,ux,ub,ub,ub,ub,ub,ub,ub,ub,ub,ur,ub,ub,ux,ux
ux,ux,ux,ux,ux,ux,ux,ux,ux,ub,ub,cb,ub,ub,ur,ub,ub,ub,ur,ub,ub,ux,cb
cg,ux,ux,ux,ux,ux,ux,ub,ub,ub,ub,ux,ub,ub,ur,ub,ux,ux,ur,ux,ub,ux,ux
cb,ux,ux,ux,ux,ux,ub,ub,ub,ub,ub,ub,ub,ub,ub,ub,ux,ub,ur,ub,ub,ux,ux
ux,ux,ux,ux,ux,ux,ub,ub,ub,ub,ub,ub,cg,ub,ub,ur,ur,ur,ur,ux,ux,cr,cb
cb,ux,ux,ux,ux,ux,cr,ub,cr,ub,ub,cg,cb,ur,ur,ur,cr,ux,ux,cr,ux,cr,cb