ur,ur,cr,ur,ur,ur,ur,cb,cb,cb,ur,cg,cg,ur,ur,ur,ur,ur,ur,ur,cb,cb,cb
ur,ur,ur,ur,ur,ur,ur,ur,ur,ur,ur,ur,cg,ur,ur,ur,ur,ur,ur,ur,ur,ur,ur
ur,cr,cb,ur,ur,ur,ur,ur,ur,ur,ur,ur,ug,ur,ur,ur,ur,ur,ur,ur,ur,ur,ur
ur,ur,ur,ur,ur,ur,ur,ur,ur,ur,ur,ur,ug,ur,ur,ur,ur,ur,ur,ur,ur,ur,ur
ur,ur,ur,ur,ur,ur,ur,ur,ur,ur,ur,ur,cr,ur,ur,ur,ur,ur,ur,ur,ur,ur,ur
ur,ur,ur,ur,ur,ur,ur,ur,ur,ur,ur,ur,ur,ur,ur,ur,ur,ur,ur,ur,ur,ur,ur
ur,ur,ur,ur,ur,ur,ur,ur,ur,ub,cb,ur,ur,ur,ur,ur,ur,ur,ur,ur,ur,ur,ur
cg,ur,ur,ur,ur,ur,ur,cr,ur,ur,cr,ur,ur,ur,ur,ur,ur,ur,ur,ur,ur,ur,cb
ug,ug,ur,ur,ur,ur,ur,ug,cg,ur,ur,ur,ur,ur,ur,ur,ur,ur,ur,ur,ur,ur,ur
ug,ug,ur,ur,ur,ur,ur,ur,ur,ur,ur,ur,ur,ur,ur,ug,ug,ur,ur,ur,ur,ur,ur
ug,ug,ur,ur,ur,ur,ur,ur,ur,ur,ur,ur,ur,ur,ur,ug,ug,ur,ur,ur,ur,ur,ur
ug,ug,ur,ur,ur,ub,ur,ug,ur,ur,ur,ur,ug,ur,ur,ug,ug,ur,ur,ur,ur,ur,ur
ug,ug,ur,ur,ub,ub,ur,ug,ur,ur,ur,ug,ug,ug,cg,ug,ug,ur,ur,ur,ur,ur,ur
ug,ug,ub,ur,ub,ub,ur,ug,ur,ur,ug,ug,ug,ug,ug,ug,ug,ur,ur,ur,ur,ur,ur
ug,ug,ub,ur,ub,ub,ur,ur,ur,ur,ur,ur,ug,ur,ug,ug,ur,ur,ur,ur,ur,ur,ur
cr,ug,ub,ub,ur,ur,ur,ur,ur,ur,ur,ur,ug,ur,ur,ur,ur,ur,cr,cr,ur,ur,ur
ur,ur,ub,ub,ub,ub,ur,ur,ur,ur,ur,ur,ur,ur,ur,ur,ur,ur,ug,ub,ur,ur,ur
ur,cb,ub,ur,ub,ub,ub,ur,ur,ur,ur,ur,ur,ur,ur,ur,ur,ur,ug,ub,ur,ur,ur
ug,ub,cr,ur,ur,ub,cb,ur,ub,ur,ur,ur,ur,ur,ur,ur,ur,ur,ug,cb,ur,ur,ur
cg,ur,ur,ur,ur,ur,ub,ur,ub,ur,ur,ur,ur,cg,ur,ur,ur,ur,ug,ur,ur,ur,ur
cb,ur,ur,ur,ur,ur,ur,ub,ub,ub,ub,ur,ur,ug,ur,ur,ur,ur,ug,ur,ur,ur,ur
ug,ug,ug,ug,ub,ur,ur,ub,cb,ub,ur,ur,cg,ug,ug,ug,ug,ug,ug,ur,ur,cr,cb
cb,ug,ug,ur,ur,ur,cr,cb,cr,ub,ub,cg,cb,ur,ur,ur,ur,ur,ur,cr,ur,cr,cb