ur,ur,cr,ur,ur,ur,cg,cb,cb,cb,ur,ur,cg,ur,ur,cb,ur,ur,ur,cb,cb,ur,cb
ur,ur,ur,ur,cr,ug,ug,ur,ur,ur,ur,ur,ur,ur,ur,ur,ur,ur,ur,ur,ux,ur,cb
ur,ur,ur,ur,cr,ug,ug,ur,ur,ur,ur,ur,ur,ur,ur,ur,ur,ur,ur,ur,ur,ur,ur
ug,ug,ug,ur,ur,ug,ug,ug,ur,ur,ur,ur,ur,ur,ur,ur,ur,ur,ur,ur,ur,ub,ub
cr,ur,ur,ur,ur,ug,ug,ug,ur,ur,ur,ur,ur,ur,ur,ur,ur,ug,ur,ur,ur,ub,ub
ur,ur,ur,ur,ur,ug,ub,ub,ub,cb,ur,ur,ur,ur,ur,ur,ux,ug,ur,ur,ur,ur,ux
ur,ug,ur,ur,ur,ug,ub,ur,ur,ur,ur,ur,ur,ur,ur,ur,ur,ug,ur,ur,ur,ub,ub
ur,ug,ug,ug,ur,ug,ub,ur,cr,cr,ub,ub,ub,ub,ur,ur,ug,ug,ur,ur,ur,ub,ub
ur,ur,ur,ug,ug,ug,ub,ur,ug,ub,ub,ub,ub,ub,ur,ur,ug,ur,ur,ux,ur,ur,ux
ux,ux,ub,cg,ux,ux,ub,ux,ub,ub,ug,cb,ub,ug,ug,ug,ug,ux,ub,ur,ur,ub,ub
ux,ux,ux,ub,ux,ux,ub,ub,ub,ub,ub,ub,ub,ur,ux,ur,ur,ux,ub,ur,ur,ur,ub
ux,ux,ux,ub,ub,ub,ub,ub,ux,cg,ug,ub,cb,ug,cg,ur,ur,ur,ur,ur,ur,ur,ub
ux,ux,ux,ux,ux,ux,ub,ub,ub,ug,ub,ub,ub,ub,ub,ub,ub,ub,ur,ur,ur,ub,ub
ug,ug,ug,ug,ug,ug,ug,ug,ug,ug,cb,ub,ur,ug,ug,ug,ug,ub,ur,ur,ur,ur,ug
ux,ug,ug,ub,ub,ur,ub,ur,ug,ur,ur,ub,ub,ub,ug,ug,ub,ub,ub,cr,ur,ub,ub
ur,ur,ug,cg,ug,ur,ub,ug,ug,ug,ur,cr,ur,ub,ub,ub,ub,ub,ub,ur,ur,ur,ur
ur,ug,ug,ub,ub,ub,ub,ux,ux,ug,ug,ug,ur,ur,ub,ux,ux,ur,ub,ur,ur,ux,ur
ur,ug,ur,ur,ur,ur,ur,ur,ur,ur,ur,ug,ub,ux,ub,ux,ux,ub,ux,ur,ur,ux,ur
cg,ux,ux,ug,ux,ug,ug,ug,ug,ug,ur,ug,ub,ux,ub,ux,ux,ub,ux,ur,ur,ux,ur
cg,ux,ux,ug,ux,ug,ug,ug,ug,ub,ur,ub,ub,ur,ub,ub,ub,cb,ub,ur,ur,ux,ur
cb,ux,ux,ug,ug,ug,ux,ux,ug,ub,ur,ub,ub,ub,ur,ur,ub,ub,ub,ur,ur,ur,ur
ux,ux,ux,ux,ux,ux,ux,ux,ux,ub,ub,ub,cg,ub,ub,ub,ub,ub,ub,ur,ur,cr,ur
ux,ux,ux,ux,ux,ux,cr,ux,cr,ub,ub,cg,cb,ub,ub,ub,cr,ub,ub,cr,ur,cr,cb