ur,ur,cr,ur,ur,ur,ur,cb,cb,cb,cg,ux,cg,ux,ux,ux,ub,ub,ux,cb,cb,ux,cb
ur,ur,ur,ur,ur,ur,ur,ur,ur,ur,ur,ur,ur,ub,ux,ux,ub,ub,ux,ux,ux,cb,cb
ur,ur,ur,cr,cr,ur,ur,ur,ur,ur,ur,ub,ur,ub,ux,ux,ub,ub,ub,ub,ux,ux,ux
cg,ur,cg,cr,ur,ur,ur,ur,ur,ur,ur,ur,ur,ux,ux,ux,ux,ub,ub,ub,cb,ux,ux
ur,ur,ug,ug,ug,cg,ur,ur,ur,ur,ur,cr,ux,ux,ub,ub,ub,ug,ug,ug,ub,ur,ur
ur,ur,ur,ur,ur,ur,ur,ur,ub,ur,ub,ub,ub,ub,ub,ux,ux,ug,ug,ug,ub,ub,ur
ur,ur,ur,ur,ub,ub,ub,ub,ub,ub,cb,ux,ux,ux,ux,ub,ub,ug,ug,ug,ub,ux,ur
ur,ur,ur,ur,ub,ub,ub,ub,ub,ub,ub,ub,ub,ub,ub,cg,ug,ug,ug,ug,ug,ug,ur
ur,ur,ur,ur,ur,cb,ub,ub,ub,ug,ug,ug,ug,ug,ug,ug,ug,ub,ug,ug,ub,ug,ug
ur,ur,ur,ur,ur,ug,ux,ub,ub,ub,ug,ug,ug,ug,ug,ug,ug,ug,ug,ux,ux,ug,ug
ur,ur,ur,ur,ur,ug,ur,ur,ur,ur,ur,ur,cr,ug,ur,ug,ur,ur,ur,ur,ur,ug,ug
ur,ur,ur,cr,ux,ub,ux,ux,ub,ub,ub,ub,ub,ug,ug,ug,ug,ug,ug,ux,ux,ux,ur
ux,ub,ub,ub,ug,ub,ug,ug,ub,ub,ug,ub,ur,ur,ur,ur,ur,ur,ur,ur,ur,ur,ur
ub,ub,ub,ub,ug,ub,ux,ux,ub,cb,ug,cg,ur,ub,ug,ug,ug,ug,ug,ux,ux,ux,cg
ub,ub,ub,ub,ug,ub,ux,ux,ux,ux,ub,ug,ug,ug,ug,ux,ux,ux,ux,ux,ux,ux,ux
ub,ub,ub,ub,ub,ub,ux,ux,ux,ux,ux,ug,ur,ux,ux,ux,ux,ux,ux,ux,ux,ux,ux
ub,ub,ub,ub,ub,ub,ux,ux,ur,ux,ub,ub,ur,ub,ux,ux,ux,ux,ux,ux,ux,ux,ux
ub,ub,ub,ub,ub,ub,ux,ub,ub,ub,ub,ux,ur,ux,ux,ux,ux,ux,ux,ux,ux,ux,ux
ub,ub,ub,ub,ub,ub,ux,ub,ub,ub,ub,ux,ur,cr,ux,ux,ux,ux,ux,ux,ux,ux,cb
cg,ub,ub,ub,ub,ub,ub,ub,ub,ub,ub,ux,ur,ur,ur,ur,ur,ur,ur,ur,ur,ur,ur
cb,ur,ub,ux,ux,ug,ug,ux,ub,ub,ub,ub,ub,ub,cb,ur,ur,ur,ur,ur,ur,ur,ur
ux,ur,ub,ub,ub,ub,ug,ug,ug,ur,ux,ux,cg,ux,ux,ux,ux,ux,ux,ux,ux,cr,ur
ux,ur,ur,ur,ub,ub,cr,ux,cr,ux,ux,cg,cb,ux,ux,ux,cr,ux,ux,cr,ux,cr,cb