ur,ur,cr,ur,ur,ur,cb,cb,cb,cb,ur,cg,cg,ur,ur,ur,ur,ur,ur,ur,cb,cb,cb
ur,ur,ur,ur,ur,ur,ur,ur,ur,cr,ug,cg,ub,ub,ub,ub,ub,ub,ub,cb,ug,ug,ur
ur,cr,cb,ub,ub,ub,ub,ur,ur,ug,ur,ur,ur,ur,ur,ur,ur,ur,ur,ur,ur,ug,ur
ur,ur,ur,ub,ur,ur,cb,ur,ur,ug,ur,ur,ur,ur,ur,ur,ur,ur,ur,ur,ur,ug,ug
ug,ur,ur,ub,ub,cr,ur,ur,ur,ug,ur,ur,ur,ur,ur,ur,ur,ur,ur,ur,ur,ug,ug
cg,ur,ur,cr,ub,ub,ub,ur,ur,ug,ur,ur,ur,ur,ur,ur,ur,ur,ur,ur,ur,ug,ug
cg,ur,ur,ur,ur,cb,ub,ur,ur,ug,ur,ur,ur,ur,ur,ur,ur,ur,ur,ur,ug,ug,ug
ur,ur,ur,ub,ur,ub,ub,ur,ur,ug,ur,ur,ur,ur,ur,ur,ur,ur,ur,ur,ug,ug,ug
ur,ur,ur,cb,ur,ub,ur,ur,cg,ug,ur,ur,ur,ur,ur,ug,ur,ur,ur,ur,ug,ug,ug
ur,ur,ur,ub,ub,ub,ur,ur,ur,ug,ur,ur,ur,ur,ur,ur,ur,ur,ur,ur,ur,ug,ug
ug,ur,ur,ur,ub,ub,ur,ur,ug,ug,ur,ur,ur,ur,ur,ur,ur,ur,ur,ur,ur,ug,ug
ug,ur,ug,ur,ur,ur,ur,ug,ug,ug,ur,ur,ur,ur,ur,ur,ug,ur,ur,ur,ur,ug,ug
ur,ur,ub,ur,ur,ur,ur,ur,ur,ur,ur,ur,ur,ur,ur,ur,ur,ur,ur,ur,ur,ug,ur
ur,ur,ur,ur,ur,ur,ur,ur,ur,ub,ur,ur,ur,ug,ug,ur,ur,ur,ur,ur,ur,ug,ur
cg,ur,ur,ur,ur,ur,ur,ub,ur,ub,ur,ub,ub,ug,ug,ur,ug,ug,ug,ug,ug,ug,ur
cb,ur,ur,ur,ur,ur,ub,ur,ur,ur,ur,ug,ub,ug,ug,ur,ug,ur,ur,ur,ur,ur,ur
ug,ug,ug,ur,ur,ur,ur,ur,cr,ur,ur,ug,ub,ub,ub,ur,ub,ur,ur,ur,ur,ur,ur
ug,ug,ug,ug,ur,ur,ur,ur,ur,ur,ur,ub,ur,ur,ub,ub,ub,ur,ur,ur,ur,ur,ur
cg,ur,ug,ug,ur,ug,ur,ug,ur,ur,ur,ub,ur,ur,ub,ub,ub,ur,ur,ur,ur,ur,ur
ug,ug,ug,ug,ur,ug,ur,ug,ug,ug,ur,ub,ub,ur,ub,ub,ub,ur,ur,ur,ur,ur,ur
cb,cb,ug,ug,ur,ur,ur,ur,ur,ur,ur,ur,ur,ur,ur,ub,ur,ur,ur,ur,ur,ur,ur
ug,ug,ug,ug,cr,ug,ub,ur,ur,ur,ur,ur,cg,ur,ur,ur,ur,ur,ur,ur,ur,cr,cb
cb,ug,ug,ug,ug,ug,cr,cr,cr,ur,ur,cg,cb,ur,ur,ur,ur,ur,ur,cr,ur,cr,cb