ur,ur,cr,ur,cr,ur,ux,cb,cb,cb,cg,ur,cg,ur,ur,ur,ur,ur,ur,cb,cb,ux,cb
ur,ug,cr,ur,ur,ur,ux,ux,ux,ur,cb,cr,ub,ur,ur,ur,ur,ur,ur,ur,ur,cb,cb
ur,ug,ug,ug,ur,ur,ur,ur,ur,ur,cr,ub,ub,ur,ur,ur,ur,ur,ur,ur,ur,ur,ur
cg,cg,ug,ug,ug,cg,ur,ur,ur,ur,ur,ub,ur,ug,ug,ur,ur,ur,ur,ur,ur,ur,ur
cb,ur,ug,ug,ug,ug,ur,ur,ur,ub,ur,ur,ur,ug,ug,ug,ug,cr,ur,ur,ur,ux,ux
ub,ub,ub,ub,ub,ub,ur,ur,ur,ur,ur,ur,ur,cg,ug,ub,ug,ux,ux,ux,ux,ux,ux
ux,ur,ug,ug,ur,ub,ur,ug,ux,ux,ug,ur,ug,ub,ug,ub,ug,ug,ux,ur,ur,ur,ur
ub,ub,ub,ub,ub,ub,ur,ur,ur,ur,ug,ur,ur,ub,ug,ug,ug,ug,ux,ur,ux,ux,ur
ub,ub,ub,ub,ub,ub,ub,ur,ur,ur,ur,ur,ur,ub,ur,ub,ub,ub,ub,ur,ur,ur,ur
ub,ub,ur,ux,ub,ub,ub,ur,ur,ur,ur,ur,ur,ub,ur,ub,ub,ur,ub,ur,ux,ux,ux
ub,ux,ur,ux,ub,ux,ux,ux,ux,ur,ur,ur,ur,ur,ur,ub,ub,ub,ub,ux,ux,ux,ux
ub,ux,ur,ub,ub,ux,ux,ug,ux,ub,ug,cb,ug,ub,ub,ub,ub,ub,ub,ub,ux,ux,ux
ub,ux,ur,ub,ux,ux,ux,ub,ub,cg,ug,ub,ug,ub,ub,ub,ub,ur,ub,ub,ux,ux,ux
ub,ux,ur,ub,ux,ux,ux,ub,ub,ub,ux,ub,ub,ub,ub,ub,ub,ur,ub,cr,ur,ur,cg
ub,ux,ur,ub,ux,ux,ub,ub,ub,ub,ug,ub,ub,ug,ug,ub,ub,cb,ub,ur,ur,ur,ub
ub,ux,ur,ub,ub,ub,ub,ux,ux,ux,ux,ug,ug,ug,ux,ux,ur,ub,ub,ur,ur,ur,cb
ub,ux,ur,ub,ub,ux,ux,ux,ux,ux,ux,ub,ux,ux,ux,ux,ur,ub,ub,ur,ur,ur,ur
ub,ux,ur,ub,ub,ub,ub,ub,ub,ub,ub,ub,ub,ux,ux,ux,ur,ub,ub,ur,ur,ur,ur
ub,ub,ur,ub,ub,ub,ur,ur,ur,ur,cr,ub,ub,ub,ub,ux,ur,ub,ub,ur,ur,ur,ur
cg,ub,ur,ub,ub,ur,ur,ub,ub,ub,ub,ub,ub,ux,ub,ux,ur,ur,ur,ur,ur,ur,ur
cb,ub,ur,ux,ub,ur,ux,ux,ux,ux,ux,ux,ux,ux,ub,ux,ur,ur,ur,ur,ur,ur,ur
ub,ub,ur,ur,ur,ur,ux,ux,ux,ux,ux,ux,cg,ub,ub,ux,ur,ur,ur,ur,ur,cr,ur
ub,ub,ub,ub,ub,ux,cr,ux,cr,ux,ux,cg,cb,ub,ub,ux,cr,ux,ux,cr,ur,cr,cb