cr,ur,cr,cb,ub,ub,ub,cb,cb,cb,cg,cg,cg,ux,ux,ux,ux,ux,cr,ur,cb,cb,cb
ur,ur,ur,cr,ur,ur,ur,ur,ur,ur,ur,ur,ur,ur,ur,ur,ur,ur,ur,ur,ux,ux,ux
ur,cr,ur,ur,ur,ur,ur,ur,ur,ur,ur,ur,ur,ur,ur,ur,ur,ur,ur,ur,ur,ur,ux
ur,ur,ur,ur,ur,ur,ur,ur,ur,ur,ur,ur,ur,ur,ur,ur,ur,ur,ur,ur,ur,ur,ur
ur,ur,ur,ur,ur,ur,ur,ur,ur,ur,ur,ur,ur,ur,ur,ur,ur,ux,ux,ux,ux,ux,cr
ur,ur,ur,ur,ur,cr,ur,ub,ub,ux,ug,ux,ur,ur,ux,ug,ur,ux,ux,cg,ux,ux,ux
ur,ur,ur,ur,ur,ub,ub,ub,ux,ux,ug,cr,ur,ur,cr,ug,ur,ug,ux,ug,ux,ux,ux
ur,ur,ux,ub,cb,ub,ub,ux,ux,ux,ug,ux,ux,ux,ux,ug,ur,ug,ux,ug,ux,ux,ux
ug,ug,ux,ub,ux,ux,ub,ux,ux,ux,ug,ux,ux,ub,ub,cb,ur,ug,ux,ug,ux,ux,ux
ug,ug,ux,ub,ux,ux,cb,ux,ux,ux,ug,ux,ux,ub,ub,ub,ur,ug,ux,ug,ux,ux,ux
ug,ug,ux,ub,ux,ub,ub,ux,ux,ux,ux,ux,ux,ub,ub,ub,ur,ug,ux,ug,ux,ux,cg
ug,ux,ux,ub,cg,ub,ub,cg,ub,ug,ug,ux,ux,ub,ux,ub,ur,ug,ux,ug,ux,ux,ug
ub,ub,ub,ub,ug,ux,ug,ug,ug,ug,ug,ug,ug,ug,ug,ub,ub,ug,ux,ug,ux,ux,ug
ug,ub,ub,ug,ug,ug,ug,ux,ux,ug,ub,ub,ub,ub,ub,ub,ub,ug,ux,ug,ux,ux,ug
ug,cb,ub,ub,ub,ug,ux,ux,ub,ug,ub,ux,ub,ub,ub,ub,ub,ug,ug,ug,ug,ug,ug
ug,ug,ub,ub,ug,ug,ux,ux,ub,ug,ub,ug,ub,ux,ub,ub,ub,ur,ur,ur,ur,ur,ur
ug,ug,ux,ux,ux,ux,ux,ux,ub,ug,ug,ug,ub,ug,ub,ub,ub,ub,ub,cb,ur,ur,ur
ug,ug,ux,ux,ux,ux,ux,ux,ub,ux,ub,ug,ug,ug,ub,ug,ug,ux,ur,ur,ur,ur,cg
ux,ux,ux,ux,ux,ux,ux,ux,ub,ub,ux,ux,ux,ux,ub,ux,ux,ux,ur,ur,ur,ur,cb
cg,ux,ux,ux,ux,ux,ux,ux,ux,ub,ub,ux,ux,ux,ub,ux,ux,ux,ur,ur,cb,ur,ux
cb,ux,ux,ux,ux,ux,ux,ux,ux,ub,ub,ux,ux,ux,ux,ux,ux,ux,ur,ub,ub,ur,cr
ux,ux,ux,ux,ux,ux,ux,ux,ux,ux,ux,ux,cg,ux,ux,ux,ux,ux,ur,ub,ub,cr,cb
cb,ux,ux,ux,ux,ux,cr,cb,cr,ux,ux,cg,cb,ux,ux,ur,ur,ur,ur,cr,ub,cr,cb