ur,ur,cr,ur,ur,ur,ur,cb,cb,cb,ur,cg,cg,ur,ur,ur,ur,ur,ur,ur,cb,cb,cb
ur,ur,ur,ur,ur,ur,ur,cg,ug,cr,ur,ur,ur,ur,ur,ur,ur,ug,ug,ug,ug,ug,ur
ur,cr,cr,ub,ub,ur,ur,ur,ur,ur,ur,ur,ur,ur,ur,ur,ur,ug,ug,ug,ug,ug,ur
ur,ur,ur,ur,ub,ur,ur,ur,ur,ur,ur,ur,ur,ur,ur,ur,ur,ur,ur,ur,ur,ur,ur
ur,ur,ur,ur,cb,ur,ur,ur,ur,ur,ur,ur,ur,ur,ur,ur,ur,ur,ur,ub,ur,ur,ur
cb,ub,ub,ub,ub,ub,ub,ub,cr,ur,ur,ur,ur,ur,ur,ur,ur,ur,ur,ur,ur,ur,ur
ur,ur,ur,ur,ur,ur,ur,ur,ur,ur,ur,ur,ur,ur,ur,ur,ur,ur,ur,ur,ur,ur,ur
cb,ur,ur,ur,ur,ur,ur,ur,ur,ur,ur,ur,ur,ur,ur,ur,ur,ur,ur,ur,ur,cb,ub
ur,ur,ur,ur,ur,ur,ur,ur,cg,ur,ur,ur,ug,ug,ug,cr,ug,ug,ug,ug,ug,ub,ub
ur,ur,ur,ur,ur,ur,ur,ur,ur,ur,ug,ug,ug,ug,ug,ur,ur,ug,ur,ub,ug,ub,ub
cb,ur,ug,ur,ur,ur,ur,ur,ur,ur,ug,ug,ug,ug,ug,ur,ur,ug,ub,ub,ub,ub,ub
ur,ur,ug,ur,ur,ur,ur,ur,ur,ug,ug,ug,ug,ug,ug,ur,ur,ug,ug,ug,ub,ub,ub
ur,ur,ug,ur,ur,ur,ur,ur,ur,ur,cg,ur,ug,ur,ug,ug,ur,ug,ug,ug,cg,ug,ug
ur,ur,ug,ur,ur,ur,ur,ur,ur,ur,ur,ur,ug,ur,ur,ur,ur,ug,ug,ur,ur,ub,ug
ur,ur,ug,cb,ur,ur,ur,ur,ur,ur,ur,ur,ug,ur,ur,ur,ur,ur,ug,ug,ug,ug,ug
ur,ur,ub,ub,ur,ur,ur,ur,ur,ur,ur,ur,ug,ur,ur,ur,ur,ur,ur,ur,ur,ub,ur
cr,ur,cr,ur,ur,ur,ur,ur,ur,ur,ur,ur,ug,ur,ur,cr,ur,ub,ub,ub,ub,ub,ur
ur,ur,ur,ur,ur,ur,ur,ur,ur,ur,ur,ur,ug,ur,ur,ur,ub,ub,ur,ub,ub,ub,ur
ur,ur,ur,ug,ur,ur,ur,ur,ur,ub,ub,ub,ug,ur,ub,ur,ub,ub,ub,ur,ur,cb,ur
cg,ur,ur,ur,ur,ug,ur,ur,ur,ur,ub,ur,cg,ur,ur,ur,ub,ub,ub,ur,ur,ur,ur
cb,ur,ur,ur,ur,ur,ur,ur,ur,ur,ur,ur,ur,ur,ur,ub,ub,ub,ub,ur,ur,ur,ur
ug,ur,ur,ur,ur,ur,ug,ug,ur,ur,ur,ur,cg,ur,ur,ur,ub,ub,ub,ur,ur,cr,cb
cb,ug,cg,ur,ur,ur,cr,cb,cr,ur,ur,cg,cb,ur,ur,ur,ub,ur,ur,cr,ur,cr,cb