ur,ur,cr,ur,ur,ur,ur,cb,cb,cb,ur,cg,cg,ur,ur,ur,ur,ur,ur,ur,cb,cb,cb
ur,ur,ur,cr,ur,ur,ur,ur,ur,ur,ur,ur,ur,ur,ur,ur,ur,cg,ur,ur,ur,ur,ur
ur,cr,ur,ur,ur,ur,cr,ub,ub,ub,ub,ur,ur,ur,ur,ur,ur,ug,ur,ur,ur,ur,cb
ur,ur,ur,ur,ur,ur,ur,ur,ur,ur,ur,ur,ur,ur,ur,ur,ur,ug,ug,ug,ug,ug,cr
ur,ur,ur,cb,ub,ub,ub,ub,ub,ub,ub,ub,cr,ur,ur,ur,cr,ub,ub,ub,ub,ug,ur
ur,ur,ur,ur,ur,ur,ur,ur,ur,ur,ur,ur,ur,ur,ur,ur,ur,ur,ur,ur,ub,ug,ur
ur,ur,ur,ur,ur,ur,ur,ur,ur,ur,ur,ur,ur,ur,ur,ur,ur,ur,ur,ur,ub,ub,ur
cb,ub,ub,ub,ub,ub,ub,ub,ub,ub,ub,ub,ub,ur,ur,ur,ur,ur,ur,ur,ub,ub,ur
ur,ur,ur,ur,ur,ur,ur,ur,cg,ur,ur,ur,ur,ur,ur,ur,ur,ur,ur,ur,ur,ur,ur
ur,ur,ur,ur,ur,ur,ur,ur,ur,ur,ur,ur,ur,ur,ur,ur,ur,ur,ur,ur,ur,ur,ur
cb,ur,ur,ur,ur,ur,ur,ur,ur,ur,ur,ur,ur,ur,ur,ur,ur,ur,ur,ur,ur,ur,ur
ug,ug,ur,ur,ur,ur,ur,ur,ur,ug,ug,ug,cg,ug,ur,ur,ur,ur,ur,ur,ur,ur,ur
ug,ug,ur,ur,ur,ur,ur,ur,ur,ur,ur,ub,ub,ub,ub,ub,ur,cb,ur,ur,ur,ur,ur
ug,ug,ur,ur,ur,ur,ur,ur,ur,ur,ur,ur,ub,ug,ug,ub,ur,ub,ub,ub,ur,ur,ur
ug,ug,ur,ur,ur,ur,ur,ur,ur,ur,ur,ub,ub,ug,cg,ub,ub,ub,cb,ub,ur,ur,ur
ug,ug,ug,ur,ur,ur,ur,ur,ur,ur,ur,ur,ug,ug,ug,ug,ur,ur,ur,ur,ur,ur,ur
ug,ug,ug,ug,ur,ur,ur,ub,ur,ub,ub,ur,ub,ub,cb,ug,ug,ur,ur,ur,ur,ur,ur
ug,ug,ug,cr,ur,ur,ur,ub,cr,ub,ub,ub,ub,ub,ug,ug,ug,ur,ur,ur,ur,ur,ur
ug,ug,ur,ur,ub,ur,ur,ur,ur,ub,ub,ub,ur,ug,ur,ur,ur,ur,ur,ur,ur,ur,ur
cg,ug,ur,ur,ur,ur,ur,ur,ur,ur,ub,ur,ur,ur,ur,ur,ur,ur,ur,ur,ur,ur,ur
cb,ug,cg,ug,ur,ur,ur,ub,ur,ur,ur,ur,ur,ur,ur,ur,ur,ur,ur,ur,ur,ur,ur
ug,ug,ug,ug,ur,ur,ur,ur,ur,ur,ur,ur,cg,ur,ur,ur,ur,ur,ur,ur,ur,cr,cb
cb,ug,ug,ug,ur,ur,cr,cb,cr,ur,ur,cg,cb,ur,ur,ur,ur,ur,ur,cr,ur,cr,cb