cr,ur,cr,ub,cb,cr,ur,cb,cb,cb,cg,cg,cg,ur,ux,ur,ur,ur,ur,ur,cb,cb,cb
cg,ur,ur,ur,ur,ux,ur,ux,ux,cr,ur,ux,ux,ur,ur,ur,ur,ur,ur,ur,ur,ur,ur
ux,cr,ur,ur,ur,ur,ur,ux,ux,ux,cb,ur,ur,ur,ux,ux,cr,ur,ux,ur,ux,ur,ur
ux,ux,ub,ur,ur,ur,ur,ur,ur,ur,ub,ub,ub,ub,ux,ux,ux,ur,ur,ur,ux,ux,ur
ux,ux,cr,ur,ur,ur,ur,ur,ur,ur,ur,ub,ub,ub,ux,ux,ub,ub,ur,ur,ub,ub,ur
ur,ur,ur,ur,ur,ur,ur,ur,ur,ur,ur,ux,ub,ub,ub,ub,ub,ux,ur,ur,ux,ub,ux
ur,ur,ur,ur,ur,ur,ur,ur,ur,ur,ur,ux,ux,ux,ux,ug,cg,ux,ux,ux,ux,ub,ux
ur,ur,ur,ur,ur,ur,ur,ur,ur,ur,ux,ux,ux,ux,ux,ug,ux,ux,ux,ux,ux,ub,ux
ur,ur,ur,cr,ub,ub,ub,ub,ux,ux,ux,ux,ux,ug,ug,ug,ux,ux,ux,ux,ug,ug,ux
ur,ux,ub,ug,ug,ug,ug,ug,ux,ux,ux,ux,ux,ug,ug,ug,ug,ug,ug,ug,ug,ug,ux
ur,ux,ub,ug,ux,ux,ux,ug,ux,ux,ux,ux,ux,ux,ug,ug,ug,ug,ug,ug,ub,ug,ux
ur,ux,cb,ug,ug,ug,ug,ug,ux,ux,ux,ux,ux,ux,ug,ug,ug,ug,ux,ug,cg,ug,ux
ur,ux,ux,ug,ug,ub,ub,ub,ub,cb,ug,ug,ug,ub,ug,ug,ug,ug,ug,ug,ux,ux,ux
ur,ux,ux,ug,ux,ub,ub,ub,ub,ub,cb,ux,ug,ux,ug,ux,ux,ux,ux,ux,ux,ux,ux
ur,ux,ux,ug,ux,ub,ub,ub,ub,ub,cg,ug,ug,ug,ug,ux,ux,ux,ug,ug,ux,ux,ux
ur,ux,ug,ug,ux,ux,ux,ux,ux,ux,ub,ug,ub,ub,ub,ub,ub,ub,ub,ub,ub,ub,ub
ur,ux,ug,ux,ux,ux,ux,ux,ux,ub,ub,ug,ub,ub,ux,ux,ux,ug,ug,ug,ux,ux,ub
ur,ur,ur,ur,ur,ur,ur,ur,ur,ur,ur,ur,ur,ur,ur,ur,ur,cr,ug,ug,ux,ux,cb
ux,ux,ux,ux,ux,cg,ug,ug,ug,ug,ug,ug,ug,ug,ug,ug,ux,ux,ux,ug,ux,ux,cb
cg,ux,ux,ux,ur,ur,ur,ur,ur,ur,ur,ur,ur,ur,ur,ug,ug,ug,ug,ug,ur,ur,ur
cb,ux,ux,ux,ur,ur,ur,ur,ur,ur,ur,cr,ux,ux,ux,ux,ux,ux,ux,ux,ux,ux,ux
ux,ux,ux,ux,ur,ur,ux,ux,ux,ux,ux,ux,cg,ux,ux,ux,ux,ux,ux,ux,ux,cr,cb
cb,ux,ux,ux,ur,ur,cr,cb,cr,ux,ux,cg,cb,ux,ux,ux,ux,ux,ux,cr,ux,cr,cb