ur,ur,cr,ur,ur,ur,ur,cb,cb,cb,ur,cg,cg,ur,ur,ur,ur,ur,ur,ur,cb,cb,cb
ur,ur,ur,ur,ur,ur,ur,ur,ur,ur,ur,ur,ur,ur,ur,ur,ur,ur,ur,ur,cr,ug,ur
ur,cr,ur,ur,ur,ur,ur,ur,ur,ur,ur,ur,ur,ur,ur,ur,ur,ur,ug,ug,ug,ug,ur
ur,ur,ur,ur,ur,ur,ur,ur,ur,ur,ur,ur,ur,ur,ur,cr,ug,ug,cg,ur,ur,ur,ur
ur,ur,ur,ur,ur,ur,ur,ur,ur,ur,ur,ur,ur,ur,ur,ur,ur,ug,ur,ub,ur,ur,ur
cb,ur,ur,ur,ur,ur,ur,ur,ur,ur,ur,ur,ur,ur,ur,ur,ur,ug,ur,ur,ur,ur,ur
cb,ur,ur,ur,ur,ur,ur,ur,ur,ur,ur,cr,ub,ur,ur,ur,ur,ug,ur,ur,ur,ur,ur
ub,ur,ur,ur,ur,ur,ur,ur,ur,ub,ub,ub,ub,ur,ur,ur,ug,ug,ur,ur,ur,ur,ur
ub,ur,ur,ur,ur,ur,ur,ur,cg,ub,ub,ug,ug,ug,ur,ur,ug,cg,ug,ur,ur,ur,ur
ub,ur,ur,cr,ub,ur,ur,ur,ub,ub,ub,ug,ug,ug,ur,ur,ur,ur,ur,ur,ur,ur,ur
cb,cb,ur,ur,ur,ur,ur,ur,ub,ub,ug,ug,ug,cr,ur,ur,ur,ur,ur,ur,ur,ur,ur
ub,ub,ur,ur,ub,ur,ur,ur,ub,ub,ug,ug,ug,cr,ur,ur,ur,ur,ur,ur,ur,ub,ur
ur,ur,ur,ur,ur,ur,ur,ug,ub,ub,ub,ub,cb,ur,ug,ug,ug,ug,ug,ur,ub,ub,ur
ur,ur,ur,ur,ur,ur,ur,ug,ug,ug,ug,ug,ug,ur,ur,ur,ug,ug,ug,ug,ur,ub,ug
ur,ur,ur,ub,ub,ur,ur,ug,ug,ug,ug,ug,ug,ur,ug,ug,ug,ur,ug,ug,ug,ub,ug
ur,ur,ur,ub,ur,ur,ur,ug,ur,ur,ug,ug,ug,ur,ug,ug,ug,ug,ug,ug,ur,ub,ur
ur,ur,ur,ur,ur,ur,ur,ug,ur,ug,ug,ug,ug,ur,ug,ug,ur,ur,ur,ug,ub,ub,ur
ur,ur,ur,ur,ur,ur,ur,ug,ur,ug,ur,ug,ug,ur,ug,ug,ur,ub,cb,ub,ub,ug,ur
ur,ur,ur,ur,ur,ur,ur,ur,ur,ur,ur,ug,ug,ur,ug,ur,ur,ug,ur,ug,cg,ug,ur
cg,ur,ur,ur,ur,ur,ur,ur,ur,ur,ub,ur,ug,ur,ug,ur,ug,ug,ur,ug,ug,ub,ur
cb,ur,ur,ur,ur,ur,ur,ur,ur,ur,ur,ur,ug,cg,ur,ur,ub,cr,ur,ug,ug,ur,ur
ug,ur,ur,ur,ur,ur,ug,ug,ur,ur,ur,ur,cg,ur,ur,ur,ub,ur,ur,ub,ub,cr,cb
cb,ug,cg,ur,ur,ur,cr,cb,cr,ur,ur,cg,cb,ur,ur,ur,ub,ur,ur,cr,cb,cr,cb