ur,ur,cr,ur,ur,ur,ur,cb,cb,cb,cg,ur,cg,ur,ur,ur,ur,cr,ur,cb,cb,ub,cb
ur,ur,ur,ur,cg,ug,ur,ur,ur,ur,ur,ur,ur,ur,ur,ur,ub,cb,ur,ur,cr,ub,ub
ur,cr,ur,ug,ug,ug,cr,ur,ur,ur,ur,ub,ub,ub,ub,ub,ub,ub,ux,ux,ux,ub,ub
cg,ur,ur,ub,ub,ur,ur,ur,ur,ur,ub,ub,ub,ur,ub,ub,ux,ux,ux,cr,ur,ur,ux
ur,ur,ur,ug,ub,ug,ug,ug,ug,ug,ug,ug,ub,ux,ux,ub,ux,ux,ux,ux,ux,ur,ux
ur,ur,cg,ug,cb,ug,ug,ub,ur,ur,ur,ug,ub,ub,ub,ub,ux,ux,ur,ur,ur,ur,ux
ur,ur,ur,ug,cr,ug,ug,ur,ur,ux,ux,ug,ub,ux,ux,ux,ug,ug,ur,ux,ux,ux,ux
ur,ur,ur,ur,ur,ug,ub,ub,ub,ux,ux,ug,ur,ur,ur,ur,ug,ug,ur,ub,ub,ux,ux
ub,ub,ub,ug,ug,ug,ub,ub,ub,ub,ur,ug,ug,ug,ug,ur,ug,ug,ur,ub,cb,ub,ux
ub,ub,ub,ub,ub,ub,ub,ub,ub,ub,ug,ug,ug,ug,ug,ur,ur,ur,ur,ub,ub,ub,ub
ub,ub,ub,ub,ub,ub,ub,ub,ub,cb,ub,ug,ub,ug,ug,ux,ux,ux,ux,ub,ux,ub,ug
cg,ub,ub,ub,ub,ub,ub,ug,ub,ub,ub,ug,ub,ug,ug,ug,ug,ux,ub,ub,ux,ux,ug
cb,ur,ur,ur,ur,cb,ub,ub,ub,ub,ub,cg,ub,ux,ug,ug,ug,ub,ub,ug,ug,ug,ug
ub,ub,ux,ux,ux,ub,ub,ub,ub,ub,ub,ur,ug,ug,ug,ug,ur,ur,ub,ub,ub,ub,ux
ub,ub,ux,ug,ug,ub,ub,ub,ub,ub,ub,ur,ur,ur,ur,ur,ur,ur,ur,ur,ur,ur,ur
ub,ub,ub,ub,ub,ub,ub,ub,ub,ub,ub,ur,ug,ux,ug,ug,ux,ux,ux,cr,ur,ur,ur
ur,ub,ux,ug,ug,ug,ug,ug,cb,ug,ug,ug,ug,ux,ug,ug,ux,ux,ux,ub,ub,ub,ux
ur,ub,ux,ug,ug,ug,ug,ug,ug,ug,ug,ug,ug,cg,ug,ug,ux,ux,ux,ux,ub,ur,ur
ur,ur,ur,ur,ur,ub,ur,ur,ur,ur,ub,ur,ur,ux,ux,ug,ux,ux,ux,ux,ub,ux,cb
cg,ur,ur,ur,ub,ub,ub,ur,ur,ur,ug,ur,ur,ur,ur,ur,ur,ur,ur,ur,ur,ur,ur
cb,ur,ub,ub,ub,ub,ub,ur,ux,ur,ub,ur,ur,ur,ur,ur,ur,ur,ur,ur,ur,ur,ur
ub,ub,ub,ub,ub,ub,ur,ur,ux,ur,ub,ub,cg,ux,ux,ux,ux,ux,ux,ux,ux,cr,ux
ub,ub,ub,ub,ub,ub,cr,ux,cr,ur,ur,cg,cb,ux,ux,ux,cr,ux,ux,cr,ux,cr,cb