ur,ur,cr,ur,cr,ur,ur,cb,cb,cb,cg,ur,cg,ux,ub,ub,ur,ur,ur,cb,cb,ux,cb
ur,ur,ur,ur,cr,cr,ug,ur,ur,ur,ur,ur,ur,ur,ub,ub,ur,ur,ur,ux,ux,cb,cb
ur,ur,ub,ub,ug,ur,cg,ur,ur,ur,ur,ur,ur,ur,ub,cb,ur,ur,ur,ur,ur,ur,ur
cg,ur,cr,cb,cg,ur,ur,ur,ur,ur,ur,ur,ur,ub,ub,ur,ur,ur,ur,ub,ub,ub,ub
ur,ur,ur,ur,ug,ug,ur,ur,ur,ur,ur,ur,ur,ub,ur,ur,ur,ur,ur,ub,ub,ub,ub
ur,ur,ug,ug,ug,ur,ug,ub,ub,ub,ur,ur,ur,ur,ur,ur,ur,ub,ub,ub,ur,ux,ux
ur,ur,ug,ug,ug,ur,ur,ur,ur,cr,ur,ur,ur,ub,ub,ub,ug,ux,ux,ur,ur,ux,ux
ur,cg,ug,ug,ur,ug,ug,ur,ug,ug,ug,ub,ub,ub,ub,ub,ux,ux,ux,ux,ub,ub,ub
ub,ub,ub,ug,ug,ug,ug,ug,ug,ur,ub,ub,ux,ub,ux,ub,ux,ux,ux,ux,ub,ux,ub
ub,ux,ub,ux,ux,ux,ur,ub,ub,ub,ub,ub,ub,ub,ux,ub,ub,ub,ux,ux,ub,ux,ub
ub,ux,ub,ux,ux,ux,ur,ub,ug,ub,cb,ub,ub,ub,ub,ub,ub,ub,ux,ux,ub,ux,ub
ub,ux,ub,ug,ug,ug,ug,ug,ug,ub,ub,ub,ub,cb,ub,ub,ub,ub,ug,ux,ub,ux,ub
ub,ux,ub,ug,ux,ux,cg,ug,ug,ug,ur,ur,ub,ub,ub,ub,ub,ub,ub,ub,ub,ub,ub
ub,ux,ub,ug,ux,ux,ug,ug,ur,ur,ur,ug,ug,ub,ub,ub,ug,ug,ug,ux,ub,ux,cg
ub,ux,ub,ug,ug,ug,ug,ub,ur,ub,ur,ug,ub,ub,ub,ub,ux,ub,ux,ux,ub,ux,ux
ub,ux,ub,ux,ux,ux,ug,ub,cr,ug,ur,ug,ub,cb,ub,ub,ux,ub,ub,ux,ub,ux,ux
ub,ux,ub,ux,ux,ux,ug,ug,ug,ug,ur,ug,ux,ux,ux,ub,ux,ux,ux,ux,ub,ux,ux
ub,ub,ub,ub,ub,ub,ux,ub,ub,ub,ur,ub,ux,ux,ux,ub,ux,ux,ux,ux,ub,ux,ux
ux,ux,ub,ux,ux,ub,ux,ux,ux,ub,ur,ux,ux,ux,ux,ub,ub,ux,ux,ux,ub,ux,cb
cg,ux,ub,ub,ub,ub,ub,ub,ub,ub,ur,ux,ux,ux,ux,ux,ub,ux,ux,ux,ub,ux,ux
cb,ux,ux,ux,ux,ub,ux,ux,ux,ux,ur,ux,ux,ux,ux,ux,ub,ux,ux,ux,ub,ux,ux
ur,ub,ub,ub,ub,ub,ub,ub,ub,ub,ur,ux,cg,ux,ux,ux,ub,ub,ub,ub,ub,cr,ux
ur,ub,ub,ub,ub,ub,cr,ux,cr,cr,ur,cg,cb,ux,ux,ux,cr,ux,ux,cr,ur,cr,cb