ur,ur,cr,ur,ur,ur,ur,cb,cb,cb,cg,cg,cg,cb,ur,ur,cr,ur,ur,ur,cb,cb,cb
ur,ur,ur,ur,ur,ur,ur,cg,ux,ux,ux,ur,ur,ur,ur,ur,ur,ur,cr,ur,ur,ur,ur
ur,cr,ur,ur,ur,ur,ur,ur,ur,ur,ur,ur,ur,ur,ur,ur,ur,cg,ug,ur,ur,ur,ur
cb,ux,ur,ur,ux,ur,ur,ur,ur,ur,ur,ur,ur,ur,ur,ur,ur,ur,ur,ur,ur,ur,ur
ur,ur,ur,ur,ur,ur,ur,ur,ux,ur,ur,ur,ur,ur,ur,ur,ur,ur,ur,ur,ur,ur,ur
ur,ur,ur,ur,ur,ur,ur,ur,ur,ur,ur,ur,ur,ur,cr,ur,ur,ur,ug,ur,ur,ur,ur
ur,ur,ur,ur,ur,ur,ur,ur,ur,ur,cr,ux,cr,ur,ur,ur,ug,ug,ug,ur,ur,ur,ur
ur,ur,cg,ug,ug,ug,ug,ug,ug,ur,ur,ur,ur,ur,ur,ur,ug,ug,ug,ur,ur,ur,ur
ur,ur,ur,ur,ur,ur,ug,ug,ur,ur,ur,ur,ur,ur,ur,ug,ug,ug,ug,ur,ur,ur,ur
ur,ur,ur,ur,ug,ug,ug,ur,ur,ub,ub,ub,ub,ub,ug,ug,ur,ur,ur,ug,ur,ur,ur
ur,ur,ur,ur,ug,ug,ug,ug,ug,ug,ub,ub,ub,ub,cg,ub,ur,ur,ur,ur,ur,ur,ug
ur,ux,ux,ux,ug,ug,cb,ub,ub,ub,ub,ub,ub,ub,ub,ub,ur,ur,ur,ur,ux,ux,ux
ur,ux,ux,ux,ug,ug,ug,ur,ur,ur,ug,ug,ur,ug,ub,ug,ug,ug,ug,ux,ux,ux,ux
ur,ux,ux,ug,cg,ur,ug,cr,ur,ur,cb,ug,ur,ug,ub,ub,ub,ub,ub,ub,ub,ub,ub
ur,ux,ux,ux,ug,ug,ug,ur,ur,ur,ub,ub,ur,ug,ug,ug,ug,ub,ub,ub,ub,cb,ub
ur,ux,ux,ux,ug,ug,ur,ur,ur,ub,ub,ub,ur,ub,ub,ug,ug,ug,ub,ub,ub,ux,ux
ur,ux,ux,ux,ux,ur,ur,ur,ur,ur,ug,ug,ur,ux,ux,ux,ux,ug,ux,ux,ux,ux,ux
ur,ux,ux,ux,ux,ur,ur,ur,ur,ur,ug,ur,ur,ur,ur,ur,ur,ur,ur,cr,ux,ux,ux
ur,ur,ur,ur,ur,ur,ur,ur,ur,ur,ux,ur,ux,ux,ux,ux,ux,ux,ux,ux,ux,ux,cb
cg,ux,ux,ux,ux,ur,ur,ur,ur,ur,ux,ur,ur,ur,ur,ur,ur,ur,ur,ur,ur,ur,ur
cb,ux,ux,ux,ux,ur,ur,ur,ur,ur,ur,ur,ur,ur,ur,ur,ur,ur,ur,ur,ur,ur,ur
ur,ur,ur,ur,ur,ur,ur,ur,ur,ux,ux,ux,cg,ux,ux,ux,cb,ux,ux,ux,ux,cr,cb
cb,ur,ur,ur,ur,ur,cr,cb,cr,ux,ux,cg,cb,ux,ux,ux,cr,ux,ux,cr,ux,cr,cb