cr,ug,ug,ug,ug,ug,ur,cb,cb,cb,ub,cg,cg,cb,ug,ug,ug,ur,ur,ub,cb,cb,cb
ug,ug,ug,ug,ug,ug,ur,ug,ug,ug,ug,ug,ug,ug,ug,ur,ur,ur,ur,ub,ub,ub,cg
ug,ug,ug,ug,ug,ug,ur,ug,ug,ug,ub,ur,ub,ub,ur,ub,ug,ur,ur,ub,ur,ur,ur
ug,ug,ux,ug,ug,ug,ur,ug,ug,ug,ug,ug,ub,ur,ur,ub,ug,ur,ur,ub,ur,ub,ur
ug,ug,ug,ug,ug,ur,ur,ur,ur,ug,ug,ug,ug,ug,ug,ug,ug,ug,ur,ur,ur,ur,ur
ug,ug,ug,ur,ur,ur,ur,cg,ug,ur,ub,ug,ug,ug,ug,ug,ug,ug,ur,ur,ur,ur,ug
ug,ug,ur,ur,ug,ur,ur,ur,ug,ug,ug,ug,ug,ug,ug,ug,ug,ug,ur,ur,ub,ur,ug
ug,ug,ug,ur,ug,ug,ur,ug,ug,ug,ub,ur,ur,ur,ur,ub,ur,ur,ub,ur,ug,ur,ug
ug,ug,ug,ur,ug,ug,cr,ug,ug,ug,ug,ug,ug,ug,ug,ug,ug,ur,ur,ur,ur,ur,ur
ug,ug,ug,ur,ug,ug,ug,ug,ug,ug,ug,ug,ug,ug,ug,ug,ug,ub,ug,ur,ur,ur,ur
ug,ug,ug,ur,ur,ur,ug,ur,cg,ub,ub,ur,ur,ur,ur,ub,ub,ub,ug,ur,ur,ur,ur
ug,ur,ur,ur,ug,ug,ug,ur,ur,ur,ub,ur,cg,ug,ug,ug,ug,ug,ug,ur,ug,ur,ur
ug,ur,ug,ug,ug,ub,ug,ur,ur,ur,ub,ur,ug,ug,ur,ur,ur,ub,ur,ur,ur,ur,ur
ug,cr,ug,ur,ug,ug,ug,ug,ur,ug,ub,ur,ug,ug,ug,ug,ug,ug,ug,cg,ug,ur,ur
ug,ug,ub,ub,ug,ug,ug,ub,ur,ur,ur,ur,ug,ug,ug,ug,ug,ug,ug,ur,ur,ur,ur
ug,ug,ub,ub,ub,ub,ub,ub,ub,ub,ub,ub,ub,cb,ub,ug,ug,ub,ub,ur,ur,ur,ur
ug,ug,ub,ub,ub,ug,ur,ur,ur,ur,ub,ur,ug,ur,cb,ug,ur,ub,ub,ur,ur,ur,ur
ug,ug,ug,ub,ub,ub,ub,ub,ub,ub,ub,ub,ub,ub,ub,ug,ur,ur,ub,ub,ur,ur,ur
ug,ug,ug,ub,ug,ug,ug,ug,ug,ug,ub,ub,ub,ub,ub,ug,ug,ub,cb,ub,ub,ur,ub
ug,ug,ug,ug,ug,ug,ug,ur,ur,ur,ub,ub,ug,ug,ur,ug,ur,ur,ub,ub,ub,ur,cr
cb,ug,ug,ug,ug,cg,ug,ub,ub,ub,ub,ub,ub,ub,ub,ub,ub,ub,ub,ur,ub,ur,ur
ub,ug,ug,ug,ug,ug,ug,ub,ur,ur,ug,ub,cg,ug,ur,ur,ug,ug,ug,ur,ur,cr,cb
cb,ug,ug,ug,ug,ug,ug,ug,ug,ug,ug,cg,cb,ug,ug,ug,ug,cb,ug,cr,ur,cr,cb