ux,ux,cr,ux,ux,ux,ux,cb,cb,cb,cg,cg,cg,cb,ur,ur,ur,ur,ur,ur,cb,cb,cb
ux,ux,ux,ux,ux,ux,ux,cg,ur,ur,ur,ur,ur,ur,ur,ur,ur,ur,ur,ur,ur,ur,ub
ux,cr,ur,ur,ur,ur,cr,ur,ur,ur,ur,ur,ur,ur,ur,ur,ur,ur,ur,ur,ub,ub,ub
cb,ur,cr,ur,ur,ur,cg,ug,cr,ur,ug,ur,ur,ur,ur,ur,ur,ur,ur,ub,ub,ur,ur
ux,ur,ur,ug,ug,ug,ug,ur,ur,ur,ug,ur,ur,ur,ur,ur,ur,ur,ur,ur,ur,ur,ur
ux,ur,ux,ug,ur,ur,ur,ur,ur,ur,cr,ur,ur,ur,ur,ur,ur,ur,ur,ur,ur,ur,ur
ux,ur,ux,ug,ug,ug,ur,ur,ur,ur,ur,ur,ur,ug,ug,ug,ug,ur,ur,cr,ux,ux,ux
ux,ur,ux,ur,ux,ug,ur,ur,ur,ur,ur,ur,ur,ur,ur,ur,cg,ur,ur,ur,ub,ux,ux
ux,ur,ur,ur,ux,ug,ug,ur,cr,ur,ur,ur,ug,ug,ur,ur,ur,ur,ub,ub,cb,ub,ux
ur,ur,ur,ur,ub,ub,ug,ub,ub,ur,ug,ug,ug,ug,ur,ur,ur,ur,ub,ub,ub,ub,cr
ur,ur,ur,ur,ub,ub,ub,ub,ug,ur,ur,ug,ug,ug,ug,ug,ug,ug,ub,ur,ur,ur,ur
ur,ur,ug,ug,ub,ub,ub,ub,ub,ur,ur,ug,ug,ug,ur,ur,ur,ur,ur,ur,ub,ur,ur
ur,ur,ug,cg,ug,ub,ub,cb,ug,ug,ur,ur,ug,ur,ub,ub,ux,ux,ub,ur,ub,ux,ur
ux,ug,ug,ug,ug,ug,ub,ub,ug,ug,cb,ub,ug,cg,ug,ux,ux,ux,ub,ur,ux,ux,ur
ux,ug,ub,ug,ux,ug,ub,ub,ub,ug,ug,ub,ug,ug,ug,ux,ux,ux,ub,ur,ux,ux,ur
ux,ux,ub,ug,ug,ug,ub,ub,ub,ub,ub,ub,ur,ur,ur,ur,ur,ur,ur,ur,ux,ux,ur
cb,ux,ub,ub,ub,ub,ub,ub,ub,ub,ur,ub,ub,ub,ux,ux,ux,ur,ur,ur,ux,ux,ur
ub,ub,ub,ub,ub,ub,ub,ub,ux,ur,ur,ub,ub,ub,ug,ug,ug,ur,ur,ur,ur,ur,ur
ub,ub,ub,ux,ux,ux,ux,ux,ux,ur,ur,ux,ux,ux,ux,ux,ux,ur,ur,ub,ub,ub,cb
cg,ux,ux,ux,ux,ux,ux,ux,ux,ur,ur,ux,ux,ux,ux,ux,ux,ur,ur,ub,ub,ub,ux
cb,ux,ux,ux,ux,ux,ux,ux,ux,ur,ur,ux,ux,ux,ux,ux,ux,ur,ur,ux,ux,ux,ux
ux,ux,ux,ux,ux,ux,ux,ux,ux,ur,ur,ux,cg,ux,ux,ux,cb,ur,ur,ux,ux,cr,cb
cb,ux,ux,ux,ux,ux,cr,cb,cr,ur,ur,cg,cb,ux,ux,ux,cr,ur,ur,cr,ux,cr,cb