ur,ur,cr,ur,ur,ur,ur,cb,cb,cb,cg,cg,cg,cb,ur,ur,ur,ur,ur,ur,cb,cb,cb
ur,ur,ur,cr,ur,ur,ur,cg,ur,ur,ur,ur,ur,ur,ur,ur,ur,ur,ur,ur,ur,ur,ur
ur,cr,ur,ur,ur,ur,ur,ur,ur,ur,ux,ur,ur,ur,ur,ur,ur,ur,ur,ur,ur,ur,ur
cb,ur,ur,ur,ur,cg,ur,ur,ur,ur,ux,ux,ur,ur,ur,ur,ur,ur,ur,ur,ur,ur,ur
ur,ur,ur,cr,ug,ug,ug,ur,ur,ur,ur,ur,ur,ur,ur,ur,ur,ur,ur,ur,ur,ur,ur
ur,ug,ug,cg,ug,ug,ug,ux,ux,ux,ur,ur,ur,ur,ur,ur,ur,ur,ur,ur,ur,ur,ur
ur,ur,ug,ug,ug,ug,ug,ug,ux,ur,ur,ur,ur,ur,ur,ur,ur,ur,ur,ur,ur,ur,ur
ur,ur,ur,ug,ug,cr,ug,ug,ur,ur,ur,ur,ur,ur,ur,ur,ur,ur,ur,ur,ur,ur,ur
ur,ur,ur,ur,ur,ur,ur,ur,ur,ur,ur,ur,ur,ur,ur,ur,ug,ur,ur,ur,ub,ur,ur
ur,ur,ur,ur,ur,ur,ur,ur,ur,cb,ur,ur,ur,ur,ur,ur,ug,ux,cr,ur,ub,cb,ur
ur,ur,ur,ur,ur,cg,ub,ub,ub,ub,ur,ur,cg,ug,ug,ug,ug,ug,ug,ur,ub,ub,ur
ur,ur,ur,cr,ug,ug,ub,ur,ur,ur,ur,ur,ur,ug,ug,ug,ug,ug,ug,ur,ur,ur,ur
ug,ug,ux,ux,ug,ug,ub,ux,ub,ub,cr,ur,ur,ug,ug,ug,ug,ug,ug,ur,ur,ux,ur
ux,ug,ux,ug,ug,ug,ub,ug,ub,ub,cb,ug,ub,ug,ug,ug,ug,ug,ub,ur,ur,ub,ur
ux,ug,ux,ux,ur,ur,ub,ub,ub,ub,ub,ub,ub,ug,cr,ur,ur,ur,ur,ur,ur,ub,ur
ux,ug,ux,ux,ur,ur,ur,ur,ur,ux,ux,ux,ug,ux,ur,ux,ux,ux,ub,ub,ur,ub,ur
ux,ug,ux,ux,ur,ur,ur,ur,ur,ux,ux,ux,ur,ux,ur,ur,ur,ur,ur,ur,ur,ux,ur
ux,ug,ug,ug,ur,ur,ur,ur,ur,ux,ux,ux,ur,ur,ur,ur,ur,ur,ur,ur,ur,ur,ur
ux,ux,ux,ux,ux,ux,ux,ux,ux,ux,ux,ux,ux,ux,ux,ux,ux,ux,ux,ux,ux,ux,cb
cg,ux,ux,ux,ux,ux,ux,ux,ux,ux,ux,ux,ux,ux,ux,ux,ux,ux,ux,ux,ux,ux,ux
cb,ux,ux,ux,ux,ux,ux,ux,ux,ux,ux,ux,ux,ux,ux,ux,ux,ux,ux,ux,ux,ux,ux
ux,ux,ux,ux,ux,ux,ux,ux,ux,ux,ux,ux,cg,ux,ux,ux,cb,ux,ux,ux,ux,cr,cb
cb,ux,ux,ux,ux,ux,cr,cb,cr,ux,ux,cg,cb,ux,ux,ux,cr,ux,ux,cr,ux,cr,cb