ub,ub,cr,ur,ur,ur,ur,cb,cb,cb,cg,ur,cg,ur,ur,cb,ur,ur,ur,cb,cb,ur,cb
ub,cb,ur,ur,ur,cg,ur,ur,ur,ur,ur,ug,ub,ub,ur,ur,ur,ur,ur,ur,ur,ur,cb
ub,cr,ur,ur,cr,ug,ur,ur,ur,ur,ur,cr,ug,ug,ug,ur,ur,ur,ur,ur,ur,ur,ur
cg,ur,ur,ur,ur,ug,ub,ug,ur,ur,ug,ub,ur,cr,ug,cg,ur,ur,ur,ur,ur,ur,ur
ur,ur,ur,ur,ur,ug,ug,ug,ub,ug,ub,ur,ux,ur,ur,ur,ur,ur,ur,ur,ur,ur,ub
ur,ur,ug,ug,ug,ug,ug,ur,ug,ug,ug,ur,ux,ur,ur,ur,ub,ur,ur,ur,ur,ur,ub
ug,ug,ug,ug,ug,ug,ug,ur,ur,ur,ur,ur,ub,ug,ux,ux,ux,ur,ur,ur,ur,ur,ub
ug,ug,ug,ug,ug,ug,ug,ub,ub,ux,ux,ux,ur,ur,ur,ur,ur,ur,cb,ub,ub,ub,ub
ux,ur,ur,ub,ur,ug,ug,ub,ub,ux,ux,ux,ur,ur,ur,ur,ur,cr,ur,ub,ux,ux,ux
ux,ux,ux,ub,ux,ug,ug,ub,ub,ur,ur,ub,ub,ur,ur,ur,ur,ub,ub,ub,ux,ux,ux
ux,ux,ux,ug,ug,ug,ug,ub,ub,ub,ub,ub,ub,ub,cb,ux,ug,ug,ux,ux,ux,ux,ux
ur,ur,ug,ug,ug,ug,ug,ug,ur,ur,ur,ur,ur,ur,ur,ur,ur,ub,ux,ux,ux,ux,ux
ub,ub,ug,ub,ug,ug,ug,ug,ug,ug,ug,ug,ug,ug,ug,cg,ur,ur,ub,ub,ub,ub,ub
ub,ux,ug,ux,ug,ug,ug,ug,ug,ug,ug,ug,ug,ug,ub,ug,ub,ur,ub,cb,ur,ux,cg
ub,ux,ug,ux,ug,ug,ug,ug,ug,ug,ub,ug,ug,ug,ug,ug,ub,ub,ub,ur,ur,ux,cr
ub,ur,ug,ur,ug,ug,ug,ug,ug,ug,ug,ug,ux,ux,ux,ux,ub,ub,ub,ur,ur,ur,ur
ub,ux,ug,ux,ur,ur,ur,ux,ux,ux,ux,ug,ux,ug,ug,ux,ub,ub,ub,ub,ub,ub,ub
ub,ux,cg,ux,ub,ur,ur,ur,ur,ur,ur,ur,ur,ur,ur,ur,ur,ur,ur,ur,ur,ur,ur
ub,ub,ub,ux,ub,ur,ux,ux,ux,ux,ux,ux,ug,ug,ug,ux,cr,ub,ub,ub,ub,ub,ur
cg,ub,ub,ux,ub,ur,ux,ux,ux,ux,ux,ux,ux,ug,ug,ux,ux,ub,ub,ub,ub,ub,ur
cb,ub,ub,cb,ur,ur,ur,ur,ur,ur,ur,ur,ur,ur,ur,ur,ur,ur,ur,ur,ur,ur,ur
ub,ub,ub,ux,ub,ur,ux,ux,ux,ux,ux,ux,cg,ux,ux,ux,ux,ux,ux,ux,ux,cr,ur
ub,ub,ub,ur,ur,ur,cr,ux,cr,ux,ux,cg,cb,ux,ux,ux,cr,ux,ux,cr,ux,cr,cb