ur,ur,cr,ur,ur,ur,ur,cb,cb,cb,ur,cg,cg,ur,ur,ur,ur,ur,ur,ur,cb,cb,cb
ur,cg,ug,cr,ur,ur,ur,ur,ur,ur,ur,ur,ur,ur,ur,ur,ur,ug,ug,ug,ug,ug,ur
ur,cr,ur,ur,ur,ur,ur,ur,ur,ur,ur,ur,ur,ur,ur,ur,ur,ug,ug,ug,ug,ug,ur
ur,ur,ur,ur,ur,ur,ur,ur,ur,ur,ur,ur,ur,ur,ur,ur,ur,ur,ur,ur,ur,ur,ur
ur,ur,ur,ur,cr,ub,ub,ub,ur,ur,ur,ur,ur,ur,ur,ur,ur,ur,ur,ub,ur,ur,ur
cb,ub,cr,ur,ur,ur,ur,ub,ur,ur,ur,ur,ur,ur,ur,ur,ur,ur,ur,ur,ur,ur,ur
ur,ur,ur,ur,ur,ur,ur,ub,cb,ur,ur,ur,ur,ur,ur,ur,ur,ur,ur,ur,ur,ur,ur
cb,ur,ur,ur,ur,ur,ur,ur,ur,ur,ur,ur,ur,ur,ur,ur,ur,ur,ur,ur,ub,ub,ub
ur,ur,ur,ur,ur,ur,ur,ur,cg,ur,ur,ur,ug,ug,ug,ur,ur,ur,ur,ug,ub,ub,ub
ur,ur,ur,ur,ur,ur,ur,ur,ur,ur,ug,ug,ug,ug,ug,ur,ur,ug,cr,ub,ub,cb,ub
cb,ur,cr,ur,ur,ur,ur,ur,ur,ur,ug,ug,ug,ug,ug,ur,cg,ug,ug,ug,ug,ub,ub
ur,ur,ur,ur,ur,ur,ur,ur,ur,ug,ug,ug,ug,ug,ug,ur,ur,ug,ug,ug,ug,ub,ub
cr,ur,ur,ur,ur,ur,ur,ur,ur,ur,ug,ur,ug,ur,ug,ug,ur,ug,ug,ug,ug,ug,ug
ur,ur,ur,ur,ub,ur,ur,ur,ug,ug,ug,ur,ug,ur,ur,ur,ur,ug,ug,ur,ur,ub,ug
ur,ur,ur,cb,ub,ur,ur,ur,ug,ug,cg,ur,ug,ur,ur,ur,ur,ur,ug,ug,ug,ug,ug
ur,ur,ur,ub,ur,ur,ur,ur,ur,ur,ur,ur,ug,ur,ur,ur,ur,ur,ur,ur,ur,ub,ur
ur,ur,ur,ur,ur,ur,ur,ur,ur,ur,ur,ur,ug,ur,ur,ur,ur,ur,ur,ur,ur,cr,ur
ur,ur,ur,ur,ur,ur,ur,ur,ur,ur,ur,ur,ug,ur,cg,ur,ub,ub,ur,ub,ub,ub,ur
ur,ur,ur,ug,ur,ur,ur,ur,ur,ub,ub,ub,ug,ur,ug,ur,ub,ub,ub,ub,cb,ub,ur
cg,ur,ur,ur,ur,ug,ur,ur,ur,ur,ub,ur,ug,ur,ug,ur,ub,ub,ub,ub,ub,ub,ur
cb,ur,ur,ur,ur,ur,ur,ur,ur,ur,ur,ur,ug,ug,ug,ub,ub,ub,ub,ur,ur,ur,ur
ug,ur,ur,ur,ur,ur,ug,ug,ur,ur,ur,ur,cg,ur,ur,ur,ub,ub,ub,ur,ur,cr,cb
cb,ug,cg,ur,ur,ur,cr,cb,cr,ur,ur,cg,cb,ur,ur,ur,ub,ur,ur,cr,ur,cr,cb