ur,ur,cr,ur,ur,ur,ur,cb,cb,cb,cg,cg,cg,ur,ur,ur,ur,ur,ux,ux,cb,cb,cb
ur,ur,ur,ur,ur,ur,ur,ur,ur,ur,ur,ur,ur,ub,ub,ub,ur,ur,ux,ux,ux,ux,ux
ur,cr,ur,ur,cg,ug,ur,ur,ur,ur,ur,ur,ur,ux,ux,ub,ub,ub,ub,ub,ux,ux,ux
cb,ur,ur,cr,ug,ug,cr,ur,ur,ur,ur,ug,ug,ub,ub,ub,ub,ub,ub,ub,ux,ux,ux
ur,ur,ug,ug,cg,ur,ur,ur,ur,ur,ur,ug,ug,ub,ub,ur,ur,ub,ub,ub,ux,cr,ux
ur,ur,ur,ur,ug,ur,ur,ur,ur,ur,ur,ug,ug,ub,ub,ur,ur,ub,ub,ub,ur,ur,ux
cr,ur,ur,ur,cr,ub,cb,cr,ur,ur,ug,ug,ub,ub,ub,ub,ub,ub,ub,ub,ur,ur,ur
ur,ur,ur,ur,ur,ug,ug,ug,ur,ug,ug,ug,ug,ub,ub,ub,ub,ub,ub,ub,ur,cb,ur
ur,ur,ur,ur,ur,ur,cg,ug,ux,ux,ur,ux,ug,ub,ub,ub,ug,ug,ug,ug,ub,ub,ur
ur,ur,ur,ur,ur,ur,ur,ux,ux,ux,ur,ux,ux,ub,ub,ub,ug,ug,ug,ug,ur,ub,ur
ur,ur,ur,ur,ub,ub,ux,ux,ux,ux,ur,ux,ux,ug,ub,ug,ug,ug,ug,ug,ub,ub,ub
ur,ur,ur,ur,ur,ub,ux,ux,ux,ux,ur,ux,ux,ug,ug,ug,ug,ug,ug,ug,ur,ub,ub
ub,ub,ur,ur,ux,ub,ux,ux,ux,ux,ur,ux,cg,ug,ub,ub,ug,ug,ug,ug,ur,ub,ub
ub,ub,ug,ux,ux,ub,ux,ux,ux,ux,ur,ux,ux,ub,ub,ug,ug,ug,ug,ug,ur,ub,ub
ub,ux,ur,cr,ux,ub,ux,ux,ux,ux,ur,ub,ub,ub,ug,ux,ux,ub,ub,ur,ur,ub,ub
ub,ub,ur,ux,ux,ub,ux,ux,ux,ub,ur,ub,ub,ug,cg,ub,ub,ub,ux,ur,ur,ub,ub
ub,ub,ur,ux,ux,ub,ux,ux,ux,ux,ur,ub,ub,ug,cb,ub,ub,ub,ub,ur,ur,ub,ub
ux,ux,ur,ux,cb,ub,ux,ux,ux,ux,ur,ux,ub,ub,ub,ub,ub,ub,ub,ur,ub,ub,ub
ux,ux,ur,ux,ub,ub,ux,ux,ux,ux,ur,ux,ub,ub,ub,ub,ub,ub,ub,ur,ub,ub,cb
cg,ux,ur,ux,ux,ur,ux,ux,ux,ur,ur,ub,ub,ub,ub,ux,ux,ux,ux,ur,ub,ub,ur
cb,ux,ur,ux,ub,ur,ub,ub,ux,ur,ur,ub,ub,ub,ub,ux,ux,ux,ux,ur,ub,ub,ub
ux,ug,ur,ux,ub,ur,ub,ub,ub,ub,ub,ub,cg,ub,ub,ub,ux,ux,ux,ur,ur,cr,cb
cb,ug,ur,ur,ur,ur,cr,cb,cr,ur,ur,cg,cb,ub,ub,ub,cr,ux,ux,cr,ur,cr,cb