ur,ur,cr,ur,ur,ur,ur,cb,cb,cb,cg,ux,cg,ux,ux,ur,ur,ux,ux,cb,cb,ur,cb
ur,ur,ur,ur,ug,cg,ur,ur,ur,cr,ub,ub,ub,ub,ub,ub,cb,ur,ur,ur,ub,ub,cb
ur,ur,ur,ur,ug,cg,ur,ur,ur,ux,ux,ur,ur,ur,ur,ur,ur,ur,ur,ub,ub,ub,ur
cg,ur,ur,ur,ug,ug,cr,ur,ur,ur,ur,ur,ur,ux,ur,ur,ur,ur,ur,ur,ub,ub,ux
ur,ur,ur,cr,ug,ug,ur,ur,ur,ur,ur,ur,ur,ur,ur,ub,ur,ux,ux,ur,ub,ux,ux
ur,ur,ur,ur,ur,ub,ub,ub,cb,ur,ur,ur,ur,ur,ur,cr,ur,ub,ub,ur,ux,ux,ux
ur,ur,ur,ur,ur,ub,ub,ub,ub,ur,ur,ur,ur,ur,ug,ux,ur,ub,ux,ur,ux,ux,ux
ur,ur,ur,ur,ur,ub,ub,cg,ub,cg,ur,ub,ux,ub,ug,ux,ug,ug,ug,ur,ub,ub,ux
ur,ur,ur,ur,ub,ub,ub,ug,ug,ug,ug,ug,ub,ub,ug,ug,ug,cg,ug,cr,ub,ub,ux
ur,ur,cr,ub,ub,ug,ug,ug,ug,ub,ux,ug,ug,ub,ug,ug,ug,ug,ug,ug,ug,ub,ub
ur,ub,ur,ux,ub,cb,ug,ub,ub,ub,ug,ug,ug,ub,ug,ug,ug,ug,ug,ub,ug,ub,ub
ug,ub,ub,ub,ub,ug,ug,ug,cb,ub,ug,ub,ub,ub,ug,ug,ug,ug,ug,ug,ug,ur,ur
ub,ur,ub,ub,ub,ug,ug,ug,ug,ug,ug,ub,ub,ug,ug,ug,ug,ug,ug,ug,ux,ux,ur
ub,ur,ug,ug,ug,ug,ug,ug,ub,ug,ug,ub,ub,ug,ug,ug,ug,ug,ug,ug,ux,ux,ur
ub,ur,ug,ug,ub,ux,ux,ug,ub,ub,ub,ub,ub,ug,ug,ug,ug,ux,ux,ux,ux,ux,ur
ub,ur,ur,ur,ur,ur,ur,ur,ur,ur,ur,ur,ur,ur,ug,ur,ug,ur,ur,ux,ux,ur,ur
cb,ub,ub,ub,ub,ub,ub,ub,ub,ub,ub,ub,ug,ub,ug,ug,ug,ub,ub,ub,ux,ur,ux
ub,ub,ub,ub,ub,ub,ub,ub,ub,ub,cr,ub,ub,ub,ur,ux,ux,ux,ux,ub,ux,ur,ux
ub,ux,ux,ux,ux,ux,ux,ux,ux,ur,ur,ub,ux,ug,ur,ur,ur,ur,ur,ub,ur,ur,cb
cg,ux,ux,ux,ux,ux,ux,ux,ux,ur,ur,ur,ur,cb,ur,ux,ux,ux,ux,ub,ux,ux,ux
cb,ux,ux,ux,ux,ux,ux,ux,ux,ur,ur,ux,ux,ub,ur,ux,ux,ux,ux,ub,ux,ux,ux
ux,ux,ux,ux,ux,ux,ux,ux,ux,ur,ur,ux,cg,ub,ub,ub,ub,ub,ub,ub,ux,cr,ux
ux,ux,ux,ux,ux,ux,cr,ux,cr,ur,ur,cg,cb,ux,ux,ux,cr,ux,ux,cr,ux,cr,cb