ur,ur,cr,ur,ur,ur,ur,cb,cb,cb,cg,cg,cg,cb,ur,ur,ur,ur,ur,ur,cb,cb,cb
ur,ur,ur,ur,ur,ur,ur,cg,ux,ux,ur,ur,ur,ur,ur,ur,ur,ur,ur,ur,ur,ur,ur
ur,cr,ur,ur,ur,ur,ur,ur,ur,ur,ur,ur,ur,ur,ur,ur,ur,ur,ur,ur,ur,ur,ur
cb,ur,ur,ur,ur,ur,ur,ur,ur,ur,ur,ur,ug,ug,ug,ur,ur,ur,cr,cr,ur,ur,ur
ur,ur,ur,ur,ur,ur,ur,ur,ur,ur,ur,ur,ug,ug,ug,ur,ur,cr,ug,ur,ur,ur,ur
ur,ur,ur,ur,ur,ur,ur,ur,ur,ur,ur,ur,cr,ug,cg,ur,ur,ug,ug,ur,ur,ur,ur
ur,ur,ur,ur,ur,ur,ur,ur,ur,ur,ur,ur,ur,ur,ur,ur,cg,ug,ur,ur,ur,ur,ur
ur,ur,ur,ur,ur,ur,ur,ur,ur,ur,ur,cr,ur,ur,ur,ur,ug,ug,ur,ur,ur,ur,ur
ur,ur,ur,ur,ur,ur,ug,ug,ur,ur,ur,ur,ug,ub,ug,cg,ur,ur,ur,ur,ur,ur,ur
ur,ur,ur,ur,ug,ug,ug,ur,ur,ub,ub,ub,ub,ub,ug,ug,ur,ur,ur,ug,ur,ur,ur
ur,ur,ur,ur,ug,ug,ug,cg,ub,ub,ub,ub,ub,cb,ug,ug,ur,ur,ur,ur,ur,ur,ug
ur,ux,ug,ug,ug,ug,ur,cr,ub,ur,ug,ur,ug,cr,ur,ur,ur,ur,ur,ur,ub,ux,ux
ur,ux,ug,ug,ug,ug,ur,ur,ub,ur,ug,ug,ug,ug,ub,ug,ug,ug,ug,ur,ub,ux,ux
ur,ug,ug,ug,ug,ur,ur,ug,ub,ur,cb,ug,ug,ug,ub,ub,ub,ub,ub,ub,ub,ux,ux
ur,ug,ux,ug,ug,ur,ur,ug,ub,ur,ub,ub,ub,ug,ug,ug,ug,ug,ub,ur,ub,ux,ux
ur,ux,ux,ux,ug,ug,ur,ug,ub,ub,ub,ub,ub,ub,ub,ug,ug,ug,cb,ub,ub,ux,ux
ur,ux,ux,ux,ux,ur,ur,ug,ug,ur,ug,ug,ux,ux,ux,ux,ux,ug,ux,ur,ux,ux,ux
ur,ub,ub,ub,ub,ur,ur,ux,ug,ur,ug,ur,ug,ug,ug,ug,ug,ug,ux,ur,ur,ur,ux
ur,ur,ur,ur,ur,ur,ur,ur,ur,ur,ux,ur,ux,ux,ux,ux,ux,ux,ux,ux,ux,ux,cb
cg,ux,ux,ux,ux,ur,ur,ur,ur,ur,ux,ur,ur,ur,ur,ur,ur,ur,ur,ur,ur,ur,ur
cb,ux,ux,ux,ux,ur,ur,ur,ur,ur,ur,ur,ur,ur,ur,ur,ur,ur,ur,ur,ur,ur,ur
ur,ur,ur,ur,ur,ur,ur,ur,ur,ux,ux,ux,cg,ux,ux,ux,cb,ux,ux,ux,ux,cr,cb
cb,ur,ur,ur,ur,ur,cr,cb,cr,ux,ux,cg,cb,ux,ux,ux,cr,ux,ux,cr,ux,cr,cb