cg,ug,cr,ur,ur,ur,ur,cb,cb,cb,ux,cg,cg,ux,ux,ux,ub,ub,ub,ub,cb,cb,cb
ug,ug,ug,cr,ux,cr,ur,ur,ur,ux,ux,ux,ux,ur,ur,ur,ub,ur,ur,cr,ur,ux,cb
ug,cr,ug,ug,ux,ur,ur,ur,ur,ur,ur,ur,ux,ux,ur,ur,ur,ur,ur,ur,ur,ux,ux
ug,ug,ug,ug,ug,ur,ur,ur,ur,ur,cb,ux,ux,ux,ux,ur,ur,ur,ur,ur,ur,ub,ux
ur,ur,ur,ur,ur,ur,ur,ur,ur,ub,ub,ug,ug,cg,ux,ur,ur,ub,ux,ub,ub,ux,ux
cb,ur,ur,ur,ur,ur,ur,ur,ur,cr,ub,ug,ux,ux,ux,ux,ub,ub,ub,ub,ug,ux,ux
ur,ur,ur,ur,ur,ur,ur,ur,ur,ur,ub,ug,ub,ux,ux,ux,ub,ug,ub,ub,ug,ux,ux
ur,ur,ur,ur,ur,ur,ur,ur,ub,cg,cb,ug,ub,ux,ux,ug,cb,ug,ux,ux,ug,ux,ux
ux,ux,ux,ux,ux,ux,ub,ug,ub,ug,ug,ug,ub,ux,ux,ug,ux,ux,ux,ux,ug,ux,ux
ux,ux,ux,ux,ux,ux,ux,ug,ug,ug,ug,ug,ub,ub,ux,ug,ux,ux,ux,ux,ug,ux,ux
ux,ux,ux,ux,ux,ux,ux,ug,ug,ug,ug,ux,ux,ub,ux,ug,ux,ux,ux,ux,ug,ux,ux
ux,ux,ux,ux,ux,ux,ux,ug,ub,ub,ub,ub,ub,ub,ug,ug,ux,ux,ux,ux,ug,ux,ux
ux,ux,ux,ux,ux,ux,ur,cb,ub,ub,ub,ub,ub,ub,ux,ux,ux,ux,ux,ux,ug,ug,ug
ub,ux,ux,ux,ux,ux,ur,ux,ux,ub,ub,ub,ux,ub,ux,ux,ux,ux,ux,ux,ur,ux,ug
ub,ux,ux,ub,ux,ux,ur,ux,ux,ub,ub,ub,ux,ub,ux,ux,ux,ux,ug,ug,ur,ux,ug
ub,ub,ub,ub,ub,ux,ur,ux,ux,ub,ub,ub,ub,ub,ug,ug,ug,ug,ug,ug,ur,ux,ug
ux,ub,ub,ux,ub,ux,ur,ux,ux,ux,ux,ux,ux,ux,ug,ux,ug,ug,ug,ug,ur,ux,ug
ux,ux,ux,ux,cb,ur,ur,ux,ux,ux,ur,cr,ux,ux,ug,ug,ub,ub,cg,ug,ur,ux,ug
ux,ux,ur,ur,ur,ux,ux,ux,ur,ur,ur,ux,ux,ux,ux,ux,cb,ub,ux,ug,ur,ub,ug
cg,ux,ur,ux,ux,ux,ux,ux,ur,ux,ux,ux,ux,ux,ux,ub,ub,ug,ug,ug,ug,ug,ug
cb,ux,ur,ur,ur,ur,ur,ur,ur,ux,ux,ux,ux,ux,ux,ub,ub,ux,ug,ug,ug,ub,ux
ux,ux,ux,ux,ux,ux,ux,ux,ux,ux,ux,ux,cg,ur,ur,ur,ur,ur,cg,ur,ur,cr,cb
cb,ux,cg,ux,ux,ux,cr,cb,cr,ux,ux,cg,cb,cr,ux,ux,ux,ux,ux,cr,ur,cr,cb