ur,ur,cr,ur,ur,ur,ur,cb,cb,cb,cg,ux,cg,ux,ux,ux,ux,ux,ux,cb,cb,ux,cb
ur,ur,ur,ur,ur,ur,ur,ur,ur,ur,ur,ur,ur,ux,ux,ux,ux,ux,ux,ux,ux,cb,cb
ur,ur,ur,ur,ur,cr,ur,ux,ux,ux,ux,ux,ur,ux,ux,ur,ux,ux,ux,ux,ur,ur,ur
cg,ur,ur,ur,ur,ur,ur,ux,ux,ux,ux,ux,ur,ux,ux,ur,ur,ux,ux,ux,ur,ur,ur
ur,ur,ug,cr,ur,ur,cr,ug,ur,ux,ur,ur,ur,ur,ur,cb,ur,ux,ux,ur,ur,ur,ur
ur,ur,ug,ug,ug,cg,ug,ug,ur,ur,ub,ub,ub,cb,ur,ub,ux,ux,ur,ur,ur,ur,ur
ur,ur,ur,ur,ug,ug,ug,ug,ur,ur,ub,ur,ur,ub,cr,ub,ur,ur,ur,ur,ur,ur,ur
ur,ur,ur,ux,ux,cg,ug,ug,ug,ur,ub,ur,ur,ub,cr,ur,ur,ur,ur,ur,ur,ur,ur
ux,ux,ux,ux,ux,ux,ur,ur,ur,ur,ub,ug,cg,ub,ub,cr,ur,ur,ur,ur,ur,ur,ur
ub,ub,ub,ux,ux,ux,ur,ur,ur,ub,ub,ug,ug,ug,ug,ur,ur,ur,ur,ur,ub,ux,ux
ub,ux,ub,ux,ux,ux,ur,ug,ub,ub,ur,ug,ug,ub,ub,ub,ur,ur,ur,ub,ub,ux,ux
ub,ux,ub,ux,ux,ux,ur,ug,ub,ub,ug,ug,ug,ub,cb,ub,ug,ur,ur,ur,ur,ur,ur
ub,ux,ub,ur,ur,ur,ur,ub,ub,ub,ub,ub,ug,ug,ub,ub,ug,ug,ub,ur,ur,ur,ur
ub,ux,ub,ux,ux,ux,ux,ub,ub,ub,ub,ug,ug,cg,ug,ub,ub,ux,ub,ub,ur,ur,cg
ub,ux,ub,ux,ux,ux,ub,ub,ub,ub,ug,ug,ub,ux,ug,ug,ub,ux,ux,ub,ur,ur,ub
ub,ux,ub,ug,ub,ub,ub,ug,ug,ur,ux,ub,ub,ub,ub,ux,ur,ux,ux,ub,ur,ur,cb
ub,ur,cb,ux,ub,ux,ux,ux,ux,ux,ub,ub,ub,ub,ub,ux,ur,ux,ux,ub,ur,ur,cr
ub,ur,ug,ug,ub,ub,ub,ub,ub,ub,ub,ub,ub,ub,ub,ub,ur,ux,ub,ub,ur,ur,ur
ub,ub,ux,ux,ub,ub,ub,ux,ux,ux,ux,ub,ub,ub,ub,ub,ur,ub,ub,ub,ur,ur,ur
cg,ub,ux,ux,ub,ux,ub,ub,ub,ub,ub,ub,ub,ub,ub,ub,ur,ub,ub,ub,ur,ur,ur
cb,ub,ux,ux,ub,ux,ux,ux,ux,ux,ux,ub,ub,ub,ub,ub,ur,ub,ub,ub,ur,ur,ur
ub,ub,ux,ux,ub,ur,ur,ur,ur,ur,ur,ur,cg,ub,ub,ub,ur,ur,ur,ur,ur,cr,ur
ub,ub,ub,ub,ub,ur,cr,ux,cr,ux,ux,cg,cb,ub,ub,ux,cr,ux,ux,cr,ur,cr,cb