ur,ur,cr,ur,ur,ur,ur,cb,cb,cb,cg,cg,cg,ur,ur,ur,ur,ur,ur,ur,cb,cb,cb
ur,ur,cr,ur,ur,ur,ur,ur,ur,ur,ur,ur,ur,ur,ur,ur,ur,ur,ur,ur,ur,ur,ur
ur,cr,ur,cr,ur,ur,ur,ur,ur,ur,ur,ur,ur,ur,ur,ur,ur,ur,ur,ur,ur,ur,ur
cb,ur,cg,cr,ur,ur,ur,ur,cg,ur,ur,ur,ur,ur,ur,ur,ur,ur,ur,ur,ur,ur,ur
ur,ur,ug,ug,ug,cg,ub,ub,ug,ub,ub,cb,ur,ur,ur,ur,ur,ur,ur,ur,ur,cr,ur
ur,ur,ug,ug,ug,ug,ub,ub,ug,ub,ub,ur,ur,ur,ur,ur,ur,ur,ur,ur,ur,ur,ur
ur,ur,ur,ur,ur,ur,ug,ug,ug,ub,cb,ub,ub,ur,ur,ur,ur,ur,ur,ur,ux,ux,ur
ur,ur,ur,ur,ur,ur,ug,ug,ug,ub,ub,ug,ub,ub,cr,ur,ux,ux,ur,ur,ug,ug,ur
ur,ur,ur,ur,ur,ug,ug,ug,ug,ug,ug,ug,ug,ub,ub,ur,ux,cg,ug,ug,ug,ug,ur
ur,ur,ur,ur,ug,ug,ug,ug,ug,ug,ug,ug,ug,ug,ug,ug,ug,ug,ug,ug,ug,ug,ub
ur,ur,ux,ux,ur,ur,ur,ug,ug,ug,ug,ug,ug,ug,ug,ub,ug,ug,ug,ug,ug,ug,ub
ur,ur,ur,ur,ur,ur,ur,cg,ug,ug,ug,ug,ub,ub,ug,ug,ug,ug,ug,ug,ug,ug,ur
ur,ur,ur,ur,ur,ur,ur,ur,ur,ur,ur,ur,ub,ux,ug,ug,ux,ug,ug,ug,ug,ug,ur
ux,ux,ux,ux,ux,ur,ur,ur,ur,ur,cb,ux,ub,ub,ug,ug,ug,ux,ux,ug,ug,ug,ur
ux,ux,ux,ur,ur,ub,ub,ub,ux,ur,ur,ur,ur,ub,ub,ub,ub,ug,ug,ug,ug,ux,ur
ux,ux,ux,ur,ur,ub,ub,ub,ub,ub,ub,ub,ub,ub,ub,ub,ub,ur,ur,ur,ur,ur,ur
ux,ur,ur,ur,ur,ur,ur,ub,ub,ub,ub,cb,ub,cr,ub,ub,ub,cr,ur,ux,ub,ux,ux
ux,ur,ur,ur,ur,ur,ur,ur,ur,ub,ub,ub,ub,ur,ub,ub,ub,ub,ur,ub,ub,ux,ux
ux,ux,ux,ux,ux,ub,ub,ub,ux,ub,ub,ux,ub,ur,ur,ub,ub,ub,ur,ub,ub,ux,cb
cg,ux,ux,ux,ux,ub,ub,ub,ub,ub,ux,ux,ub,ur,ur,ub,ux,ux,ur,ux,ub,ux,ux
cb,ux,ux,ux,ux,ux,ub,ub,ub,ub,cb,ub,ub,cb,ub,ub,ux,ub,ur,ub,ub,ux,ux
ux,ux,ux,ux,ux,ux,ub,ub,ub,ub,ub,ub,cg,ub,ub,ur,ur,ur,ur,ux,ux,cr,cb
cb,ux,ux,ux,ux,ux,cr,ub,cr,ub,ub,cg,cb,ur,ur,ur,cr,ux,ux,cr,ux,cr,cb