cr,ur,cr,ug,ug,ug,ur,cb,cb,cb,ur,cg,cg,ur,ur,ur,ub,ur,ur,ur,cb,cb,cb
cg,ur,ub,ub,ug,ug,ub,ub,ur,ur,ur,ur,ur,ur,ur,ur,ur,ur,ur,ur,ur,ur,ur
ug,cr,ug,ug,ug,ug,ug,ug,ur,ur,ur,ur,ur,ur,ur,ur,ur,ur,ur,ur,ur,ur,ur
ug,ug,ug,ug,ug,ug,ug,ub,ur,ur,ur,ur,ur,ur,ur,ur,ur,ur,ur,ur,ur,ur,ur
ug,ug,ug,ug,ug,ug,ug,ub,ur,ub,ub,cg,ur,ur,ur,ur,ur,ur,ur,ur,ur,ur,ub
ug,ug,ur,ur,ur,ur,ug,ug,ur,ub,ub,ug,ub,ur,ub,ub,ub,ub,cr,ur,ur,ub,ub
cg,ug,ur,ug,ug,cr,ub,ub,ur,ug,ub,ug,ub,ur,ur,ub,ub,ub,cb,ur,ub,ub,ub
ub,ug,cb,ug,ug,ug,cb,ub,ur,ub,ub,ug,ub,ur,ub,ub,ub,ub,ug,ur,ur,ur,ub
ug,ug,ub,ug,ug,ur,ub,ub,ub,ub,ub,ug,ub,ur,ug,ub,ur,ur,ur,ur,ub,ur,ub
ug,ug,ub,ug,ug,ub,ub,ub,ub,ub,ub,ug,ub,ub,ub,ub,ub,ub,ub,ur,ub,ur,ub
ug,ug,ub,ug,ug,ug,ub,ub,ub,ur,ub,ug,ub,ub,ug,ug,ug,ur,ur,ur,ur,ur,ub
ug,ug,ub,ur,ub,ub,ur,ur,ur,ug,ub,ug,ub,ub,ug,ug,ub,ur,ub,ur,ub,ur,ub
ug,ub,ub,ub,cb,ub,ub,ub,ur,ur,ub,ug,ub,ub,ub,ug,ug,ur,ug,ur,ub,ub,ub
ug,ug,ub,ub,ug,ub,ub,ub,ub,ur,ub,ug,ug,ug,ug,ug,ug,ur,ub,ur,ur,ur,ub
cg,ug,ub,ug,ug,ub,ur,ur,ur,ur,ug,ug,ug,ug,ug,ug,ur,ur,ug,cg,ub,ub,ub
ub,ub,ub,ub,ug,ur,ur,ur,ur,ur,ug,ug,ug,ug,ug,ug,ug,ug,ug,ug,ub,ub,ub
ub,ug,ur,ug,ug,ur,ur,ur,ur,ur,ur,ug,ub,ur,ub,ub,ur,ub,ug,ug,ur,ur,ub
ub,ug,ur,ug,ug,ug,ug,ur,ur,ur,ug,ug,ub,ur,ub,ug,ug,ug,ug,ug,ur,ur,ub
ub,ug,ur,ub,ug,ug,ug,ug,ub,ur,cr,ug,ug,ug,ug,ug,ug,ug,ug,ub,ur,ur,ub
ub,ub,ub,ub,ug,ug,ug,ub,ub,ur,ur,ug,ub,ub,ub,ub,ub,ub,ub,ub,cb,ub,ub
cb,cb,ub,ub,ug,ub,ub,ub,ub,ur,ur,ug,ub,ub,ub,ub,ub,ug,ur,ur,ur,ur,ug
ug,ug,ug,ug,ug,ug,ug,ug,ug,ur,ur,ug,cg,ub,ub,ub,ub,ug,ur,ur,ur,cr,cb
cb,ug,ug,ug,ug,cg,cr,ug,cr,ur,ur,cg,cb,ub,ub,ub,ur,ur,ur,cr,ub,cr,cb