ur,ur,cr,cb,ur,ur,ub,cb,cb,cb,ur,cg,cg,ur,ur,ur,ur,ur,ur,ur,cb,cb,cb
ug,ug,ug,ug,ug,cg,ur,ur,ur,ur,ur,ur,ur,ur,ur,ur,ur,ur,ur,ur,ur,ur,ur
ug,cr,ur,ur,ur,ur,ur,ur,ur,ur,ur,ur,ur,ur,ug,ub,ug,ur,ub,ub,ub,ub,ur
ug,ur,ur,ur,ur,ub,ur,ur,ur,ur,ur,ur,ur,ur,ur,ur,ug,ur,ur,ur,ur,ur,ur
ug,ug,ur,ur,ug,ug,ug,ug,ug,ug,ug,cr,ug,ur,ug,ug,ug,ur,ug,ur,ur,ur,ur
cg,ug,ur,ug,ur,ug,ur,ur,ur,ur,ur,ur,ug,ur,ug,ug,ug,ur,ug,ur,ur,ub,ur
cg,ug,ur,ug,ub,ub,ur,ub,ub,ub,ug,ur,ug,ug,ur,ug,ug,ur,ub,ur,ur,ur,ur
ug,ug,ub,ug,ub,ub,ub,ub,ub,ub,ug,ur,ug,ug,ur,ug,ug,ur,ug,ur,ur,ur,ur
ug,ug,ub,ug,ur,ub,cb,ub,ub,ub,cr,ug,ug,ug,ur,ug,ug,ur,ur,ur,ub,ur,ur
ug,ug,ug,ug,ur,ub,ub,ur,ur,ur,ur,ug,ug,ur,ur,ur,ug,ur,ug,ug,ub,ur,ur
ug,ug,ug,ug,ub,ub,ub,ur,ug,ug,ur,ug,ur,ur,ur,ug,ug,ur,ur,ug,ur,ur,ur
ug,ug,ug,ug,ug,ug,ub,ur,ur,ur,ur,ug,ug,ur,ur,ur,ug,ur,ur,ur,ur,ur,ur
ug,ug,ug,ug,ur,ur,ug,ug,ur,ug,ug,ur,ug,ug,ug,ug,ur,ub,ur,ub,ub,ub,ub
ug,ug,ug,ug,ug,ug,ug,ug,ur,ug,ug,ur,ur,ug,ug,ug,ur,ur,ub,ub,ub,ur,ub
cg,ug,ug,ug,ub,ug,ug,ug,ur,ur,ur,ur,ur,ug,ug,ug,ur,ub,ub,ub,ub,ur,ub
cb,ug,ug,ug,ug,ug,ub,ur,ug,ug,ug,ug,ug,ug,ug,cg,ub,ub,ub,ub,ub,ur,ub
ug,ug,ug,ug,ub,ub,ub,ub,ug,ug,ug,ug,ug,ug,ug,ug,ub,ub,ur,ub,ub,ur,ur
ug,ug,ug,ug,ug,ug,ub,ug,ug,ur,ur,ur,ur,ur,ur,ur,ur,ur,ur,cb,ub,ur,ur
ug,ug,ug,ug,ug,ug,ub,ur,ur,ur,cb,ug,ur,ur,ur,ur,ur,ur,ur,cr,ub,ur,ur
ug,ug,ug,ug,ug,ug,ub,ub,cr,ub,ub,ur,ur,ur,ug,ur,ub,ub,ur,ur,ub,ur,ur
cb,cb,ug,ug,ug,ug,ub,ub,ur,ur,ub,ur,ur,ur,ur,ur,ub,ur,ur,ur,ur,ur,ur
ug,cg,ub,ub,ub,cb,ug,ub,ur,ur,ub,ur,cg,ur,ur,ur,ur,ur,ur,ur,ur,cr,cb
cb,ug,ug,ug,ug,ug,cr,ub,cr,ur,ub,cg,cb,ur,ur,ur,ur,ur,ur,cr,ur,cr,cb