ur,ur,cr,ur,ur,cg,ur,cb,cb,cb,cg,ux,cg,ux,ux,ux,ur,ur,ur,ur,cb,ux,cb
cr,ur,ur,ur,ug,ug,ur,ur,ux,ux,ux,ux,ur,cr,cb,ub,ub,cr,ur,ur,ub,ur,ur
ur,ur,ur,ur,ur,cr,ur,ur,ux,ur,ur,ur,ur,ur,ur,ur,ux,ub,ur,ur,ub,ur,ur
cb,ur,ur,ug,ug,ug,ur,ux,ur,ur,ur,ur,ur,ur,ur,ur,ur,ur,ub,ub,ur,ur,ur
ur,ur,cg,ug,ug,ug,ug,ug,ug,ur,ur,ur,ur,ur,ur,ur,ur,ub,ur,ub,ub,ur,ur
ug,ug,ug,ug,ug,ug,ug,ug,ug,ur,ub,ub,ur,ur,ur,ur,ub,ux,ur,ur,ub,ur,ur
ug,ug,ug,ug,ug,ug,ug,ug,ug,ub,ub,ub,cr,ur,ub,ub,cr,ux,ur,ur,ub,ur,ur
ur,ur,ur,ur,ug,ug,cg,ug,ug,ub,ub,ub,ub,ub,ub,ub,ur,ur,ur,ur,cb,ur,ur
ur,ur,ur,ur,ug,ug,ug,ug,ub,ub,ub,ub,ub,ub,ub,ub,ur,ur,ur,ur,ur,ux,ub
ub,ur,ur,ux,ug,ug,ug,ug,ug,ug,ug,ub,ub,ub,ub,ub,ur,ur,ur,ux,ub,ux,ub
ub,ub,ub,ug,ug,ug,ub,ub,ug,ug,ux,ux,ux,ub,ub,ub,ub,ub,cb,ur,ur,ur,ur
ub,ub,ub,ug,ub,ug,ub,ub,ug,ug,ug,ux,ug,ug,ub,ub,ux,ub,ub,ux,ub,ux,ur
ub,ub,ub,ug,ub,ug,ug,ub,ug,ug,ug,ux,cg,cb,ub,ub,ux,ub,ub,ux,ub,ux,ur
ub,ub,ub,ub,ub,ub,ub,ub,ub,ub,ub,ub,ub,ub,ub,ub,ub,ub,ub,ug,ur,ur,ur
ub,ub,ux,ug,ug,ug,ug,ub,ub,ub,ux,ux,ux,ub,ub,ux,cb,ub,ub,ug,cr,ur,ux
ux,ub,ug,ug,ug,ug,ug,ub,ub,ux,ux,ux,ub,ub,ub,ub,cg,ug,ug,ug,ur,ug,ug
ux,ub,ux,ux,ub,ub,ub,ub,ub,ub,ux,ux,ux,ug,ug,ug,ug,ug,ug,ug,ur,ur,ug
ux,ub,ub,ub,ub,ub,ux,ub,ux,ub,ub,ug,ug,ug,ug,ug,ug,ur,ur,ub,ur,ug,ug
ux,ux,ux,ux,ub,ub,ub,ux,ux,ux,ux,ug,ug,ug,ug,ug,ug,ur,ur,ux,ur,ur,cb
cg,ux,ux,ux,ux,ub,ub,ux,ux,ux,ub,ub,ub,ub,ux,ux,ug,ur,ur,ur,ur,ur,ur
cb,ux,ux,ux,ux,ub,ub,ux,ux,ux,ub,ux,ub,ub,ux,ux,ux,ur,ur,ur,ur,ur,ur
ux,ux,ux,ux,ux,ub,ub,ux,ux,ux,ub,ux,cg,ux,ux,ux,ux,ur,ur,ur,ur,cr,cb
ux,ux,ux,ux,ux,ux,cr,ux,cr,ux,cb,cg,cb,ux,ux,ux,cr,ur,ur,cr,ur,cr,cb