cr,ur,cr,ug,ug,ug,ur,cb,cb,cb,ub,cg,cg,ub,ug,ug,ug,ug,ug,ug,cb,cb,cb
ur,ur,ur,ug,ug,ug,ur,ug,ug,ub,ub,ub,ub,ug,ug,ug,ug,ug,ug,ug,ug,ub,cg
ur,ur,ur,ug,ug,ug,ur,ug,ub,ub,ub,ub,ub,ug,ug,ug,ug,ug,ug,ug,cr,ur,ur
ur,ur,ur,ug,ug,ug,ur,ug,ub,ug,ug,ub,ub,ug,ug,ug,ug,ur,ug,ur,ug,ug,ur
ur,ur,ur,ur,ur,ur,ur,ur,ub,ub,ug,ub,cg,ug,ug,ug,ug,ug,ug,ug,ug,ug,ur
ug,ur,ur,ug,ug,ug,ug,ug,ub,ug,ug,ub,ug,ug,ug,ug,ug,ur,ur,ug,ub,ub,ur
cg,ur,ur,ug,ug,ug,ur,ub,ub,cb,ub,ub,ur,ur,ug,ur,ur,ur,ur,ur,ub,ug,ur
ub,ur,ur,ur,ug,ug,ur,ub,ub,ub,ub,ub,ur,ug,ug,ug,ur,ur,ur,ur,ub,ug,ur
ub,ur,ur,ur,ug,ug,ur,ub,ug,ub,ug,ub,ug,ug,ug,ur,ur,ug,ur,ur,ub,ug,ur
ub,ur,ur,ur,ug,ug,ur,ub,ug,ub,ug,ub,ug,cr,ur,ur,ub,ug,ug,ur,ub,ug,ur
ub,ur,ur,ur,ug,ur,ub,ub,ub,ub,ug,ub,ur,ug,ug,ug,ub,ug,ub,ug,ub,ug,ur
ub,ur,ur,ug,ug,ub,ub,ub,ub,ub,ub,cb,ub,ug,ug,ug,ub,ub,ub,ub,ub,ug,cb
ub,ur,ur,ur,ur,ur,ub,ub,cg,ub,ub,ub,ug,ug,ug,ug,ug,ug,ub,ub,ub,ub,ub
ub,ur,ur,ur,ug,ur,ur,ug,ug,ug,ub,ub,ur,ur,ug,ur,ur,ug,cb,ub,ub,ub,ub
ub,ug,ur,ur,ug,ur,ur,ub,ug,ur,ug,ug,ug,ug,ug,ug,ug,ug,ur,ub,ub,ub,ub
ug,ug,ug,ur,ub,ur,ur,ub,ug,cg,ug,ub,ug,ug,ug,ug,ug,ug,ub,ub,ub,ub,ub
ug,ug,ug,ur,ur,ur,ur,ur,ug,ur,ub,cb,ub,ur,ug,ur,ur,ug,ur,ub,ub,ub,ub
ug,ug,ug,ug,ug,ug,ur,ur,ug,ug,ug,ub,ub,ug,ug,ur,ub,cb,ur,ub,ub,ub,ur
ug,ug,ug,ug,ug,ur,ur,ug,ug,ug,ub,ub,ub,ur,ug,ub,ub,ub,ub,ub,cb,ub,ur
ug,ug,ug,ub,ub,ub,ub,ub,ug,ub,ub,ub,ub,ub,ub,ub,ur,ub,ub,ub,ub,ur,ur
cb,ug,ug,ug,ug,ug,ur,ur,ug,cg,ug,ub,ub,ub,ub,ub,ub,ub,ub,ub,ub,ur,ur
ug,ug,ug,ug,ug,ug,ug,ug,ug,ug,ug,ub,cg,ur,ur,ub,ub,ur,ur,ur,ub,cr,cb
cb,ug,ug,ug,ug,ug,cr,ug,ug,ug,ur,cg,cb,ur,ur,ub,ub,ub,ug,cr,ub,cr,cb