cb,ub,cr,ur,ur,cr,ur,cb,cb,cb,cg,cg,cg,ur,ur,ur,ur,ur,ur,ur,cb,cb,cb
cg,ur,ur,ur,ur,ur,ur,ur,ur,ur,ur,ur,ur,cb,cr,ur,ur,ur,ur,ur,ur,ur,ur
ux,cr,ur,ur,ur,ur,ur,ur,ur,ur,ur,ur,ur,ub,ub,ur,ur,ur,ur,ur,ur,ur,ur
ur,ur,ur,ur,ur,ur,ur,ur,ur,ur,ur,ur,ur,ur,ur,cr,ur,ur,ur,ur,ur,ur,ux
ur,ur,ur,ur,ur,ur,ur,ur,ur,ur,ur,ur,ur,ug,ur,ur,ur,ur,ux,ug,ur,ur,ux
ur,ur,cr,ur,ur,ur,ur,ur,ur,ur,ur,ur,ug,ug,ur,ur,ub,ug,ug,ug,ux,ux,ux
ur,ur,ur,cr,ug,ur,ug,ur,ur,cg,ug,ug,ug,ug,ub,ub,ub,ux,ug,ug,ug,ur,ux
ur,ug,ug,ug,ug,ur,ug,ur,ub,ub,ug,ub,ub,ug,ub,ug,ug,ug,ug,ug,ug,ur,ux
ur,ug,cg,ur,ux,ur,ux,ur,ug,ug,ug,ub,ub,ub,ub,ub,ub,ub,ug,ur,ux,ux,ux
ur,ur,ur,ur,ur,ur,ux,ug,ug,ux,ug,ub,ub,ug,ug,ur,ub,ub,ux,ux,ux,ux,ux
ur,ur,ur,ug,ux,ug,ug,ug,ug,ub,ub,ub,ub,ub,ug,ur,cb,ug,ug,ug,ug,ug,ux
ur,ur,ur,ug,ug,ug,ux,ux,ux,ub,ub,ub,ub,ub,ub,ub,ug,ug,ug,ug,ug,ug,ux
ur,ur,ur,ug,ug,ux,ug,ug,ug,ug,ug,ug,ub,ub,ub,ub,ub,ug,ug,ug,ug,cg,ux
ur,ur,ur,ur,ur,ur,ur,ur,cr,ub,cb,ub,ub,ub,ub,ub,ub,ug,ug,ux,ug,ux,ux
cg,ur,cr,ug,ug,ug,ug,ug,ug,ug,ug,ub,ub,ub,ub,ub,ub,cb,ug,ux,ug,ux,ux
ux,ub,ug,ug,ux,ug,ug,ug,ux,ub,ub,ub,ub,ub,ub,ub,ug,ug,ug,ug,ug,ux,ux
ux,ub,ub,ub,ub,ux,ug,ug,ug,ug,ug,ug,ug,ux,ug,ur,ux,ux,ux,ux,ux,ux,ux
ub,ub,ub,ub,ub,ux,ux,ux,ux,ux,ux,ux,ug,ux,ug,ur,ux,ux,ux,ux,ux,ux,ux
ub,ub,ub,ub,ux,ux,ux,ur,ux,ux,ux,ux,ug,ug,ug,ur,ux,ux,ux,ux,ux,ux,cb
cg,ub,ub,ub,cb,ux,ux,ur,ux,ux,ux,ux,ux,ux,ur,ur,ux,ux,ux,ux,ux,ux,ux
cb,ub,ub,ur,ur,ur,ur,ur,ux,ux,ux,ux,ux,ux,ur,ur,ux,ux,ux,ux,ux,ux,ux
ux,ub,ux,ux,ux,ux,ux,ux,ux,ux,ux,ux,cg,ux,ur,ur,ux,ux,ux,ux,ux,cr,cb
cb,ux,ux,ux,ux,ux,cr,cb,cr,ux,ux,cg,cb,ux,ur,ur,cr,ux,ux,cr,ux,cr,cb