ur,ur,cr,ur,ur,ur,ur,cb,cb,cb,cg,ur,cg,ux,ux,ur,ur,ur,ur,cb,cb,ux,cb
ur,ur,ur,ur,ug,ur,ur,ur,ur,ur,ur,ur,ux,cr,ur,ur,ur,ur,ur,ur,ur,cb,cb
ur,ur,ur,ur,cg,cr,ur,ur,ur,ur,ur,ur,ur,ur,ur,ur,ur,ur,ux,ux,ur,ux,ux
cg,ur,ur,ug,cg,cr,ur,ub,cb,ur,ur,ur,ur,ur,ur,ur,cr,ur,ub,ub,ub,ub,ub
ur,ug,ug,ug,ug,ug,ub,ub,ur,ur,ur,ur,ur,ur,ub,ub,ub,ub,ub,ub,ub,ub,ub
ur,ur,ur,ur,ug,ug,ug,ur,ur,ur,ur,ur,ur,cb,ub,ur,ur,ur,ur,ur,ur,ur,ux
ur,ur,ur,ub,ug,ug,ug,ur,ur,ur,ur,ur,ur,ur,ur,ur,cg,ug,ug,ug,ug,ur,ux
ux,ug,ug,ug,ug,ug,ug,ug,ug,ug,cr,ur,ur,ux,ux,ux,ug,ug,ug,ug,ug,ur,ux
ux,ur,ur,ur,ug,ug,ug,ub,ub,ub,ur,ub,ux,ux,ux,ux,ux,ux,ux,ux,ub,ub,ux
ux,ur,ur,ug,ur,ur,ur,ur,ur,ur,ub,ub,ub,ub,ub,ub,ur,ub,ub,ub,ub,ub,ur
ur,ur,ur,ur,ur,ur,ur,ur,ur,ur,ub,ur,ub,ub,ug,ug,ug,ug,ug,ug,ur,ub,ux
ux,ux,ux,ux,ux,ux,ur,ur,ur,ub,ub,ur,ub,ub,ub,ug,ug,ug,ug,ug,ur,ur,ux
ub,ub,ub,ub,ub,ub,ur,ub,ug,ub,ub,ug,cg,ub,cb,ug,ug,ug,ug,ug,ur,ur,ux
ub,ub,cr,ur,ur,ub,ur,ub,ug,ub,ub,ug,ug,ug,ug,ug,ug,ug,ug,ug,ur,ur,ux
ub,ub,ub,ub,cb,ux,ub,ub,ub,ub,ub,ux,ug,ug,ug,ug,ug,ug,ug,ux,ur,ux,ux
ub,ub,ub,ub,ub,ur,ur,ux,ux,ub,ug,cb,ug,ug,ux,ux,ub,ub,cg,ug,ur,ux,ux
ub,ub,ub,ub,ub,ux,ux,ux,ux,ub,ub,ub,ub,ub,ux,ux,ur,ub,ur,ur,ur,ux,ux
ub,ub,ux,ur,ur,ux,ux,ux,ux,ux,ub,ub,ub,ub,ux,ug,ub,ub,ug,ug,ux,ux,ux
ux,ux,ux,ur,ur,ux,ux,ux,ux,ux,ux,ub,ub,ux,ux,ux,ub,ub,ux,ux,ur,ur,cb
cg,ux,ux,ur,ur,ux,ux,ux,ux,ux,ux,ur,ur,ur,ur,ur,ur,ur,cr,ux,ur,ur,ur
cb,ux,ux,ur,ur,ur,ur,ur,ur,ur,ur,ur,ur,ur,ur,ur,ur,ur,ur,ur,ur,ur,ur
ur,ur,ur,ur,ur,ur,ur,ur,ur,ur,ur,ur,cg,ux,ub,ub,ub,ur,ur,ur,ur,cr,ur
ur,ur,ur,ur,ur,ur,cr,ux,cr,ux,ux,cg,cb,ux,ux,ux,cr,ux,ux,cr,ur,cr,cb