ur,ur,cr,ur,ur,ur,ur,cb,cb,cb,cg,ux,cg,ux,ux,ux,ux,ux,ux,cb,cb,ux,cb
ur,ur,ur,ur,ur,ur,ur,ur,ur,ur,ur,ur,ur,ux,ux,ux,ux,ux,ux,ux,ux,cb,cb
ur,ur,cr,cr,ug,ur,ur,ux,ux,ux,ux,ux,ur,ux,ux,ur,ux,ux,ux,ux,ur,ur,ur
cg,ur,cr,ug,ug,ur,ur,ur,ur,ur,ux,ux,ur,ux,ux,ur,ur,ux,ur,ur,ur,ur,ur
ur,ur,ur,cg,ug,ug,ug,ug,ur,ur,ur,ur,ur,ur,ur,ur,ur,ur,ur,ur,ur,ur,ur
ur,ur,ur,ur,ug,ug,ug,ug,ur,ur,ur,ur,ur,ur,ur,ur,ux,ur,ur,ur,ur,ur,ur
ur,ur,ur,ur,ug,ug,ug,cg,ur,ur,ur,ur,ub,ub,ur,ur,ur,ur,ur,ur,ur,ur,ur
ur,ur,ur,ux,ux,ur,ur,ur,ur,ur,cb,ur,cr,ub,ub,cr,ub,ur,ur,ur,ur,ur,ur
ux,ux,ux,ux,ux,ux,ur,ur,ur,ur,ub,ub,ur,ub,cb,ur,ub,ur,ur,ur,ur,ur,ur
ub,ub,ub,ux,ux,ux,ur,ur,ur,ub,ub,ub,cg,ug,ug,ug,cr,ur,ur,ur,ub,ux,ux
ub,ux,ub,ux,ux,ux,ur,ug,ub,ub,ur,ub,ur,ub,ub,ub,ur,ur,ur,ub,ub,ub,ub
ub,ux,cb,ux,ux,ux,ur,ug,ub,ub,ug,ug,ug,ub,ub,ub,ug,ur,ur,ur,ur,ur,ur
ub,ur,ur,ur,ur,ur,ur,ub,ub,ub,ub,ub,ug,ug,ug,cg,ug,ug,ub,ur,ur,ur,ur
ub,ur,ux,ux,ux,ux,ux,ub,ub,ub,ub,ug,ug,ug,ub,ub,cb,ux,ub,ub,ur,ur,cg
ub,ux,ux,ux,ux,ux,ub,ub,ub,ub,ug,ug,ub,ux,ug,ug,ub,ux,ux,ub,ur,ur,ub
ub,ux,ug,ug,ub,ub,ub,ug,ug,ur,ux,ub,ub,ub,ub,ux,ur,ux,ux,ub,ur,ur,cb
ub,ur,ug,ux,ub,ux,ux,ux,ux,ux,ub,ub,ub,ub,ub,ux,ur,ux,ux,ub,ur,ur,ur
ub,ur,ug,ug,ub,ub,ub,ub,ub,ub,ub,ub,ub,ub,ub,ub,ur,ux,ub,ub,ur,ur,cr
ub,ub,ux,ux,ub,ub,ub,ux,ux,ux,ux,ub,ub,ub,ub,ub,ur,ub,ub,ub,ur,ur,ur
cg,ub,ux,ux,ub,ux,ub,ub,ub,ub,ub,ub,ub,ub,ub,ub,ur,ub,ub,ub,ur,ur,ur
cb,ub,ur,ur,ub,ux,ux,ux,ux,ux,ux,ub,ub,ub,ub,ub,ur,ub,ub,ub,ur,ur,ur
ub,ub,ux,ux,ub,ur,ur,ur,ur,ur,ur,ur,cg,ub,ub,ub,ur,ur,ur,ur,ur,cr,ur
ub,ub,ub,ub,ub,ur,cr,ux,cr,ux,ux,cg,cb,ub,ub,ux,cr,ux,ux,cr,ur,cr,cb