ug,ug,cr,cb,ur,ur,ur,cb,cb,cb,cg,ur,cg,ur,ur,ur,ur,ur,ur,cb,cb,ur,cb
ug,ug,ug,ur,ur,ur,ur,ur,ur,ur,ur,ur,ux,ur,ur,ur,ur,ur,ur,ur,ur,ur,ur
cg,ur,ur,ub,cb,ur,ur,ur,ur,ur,ur,ur,ux,ur,ur,ur,ur,ur,ur,ur,ur,ur,ur
cr,ur,ur,ub,ur,ur,ug,ur,ux,ux,ux,ux,ux,ur,ur,ur,ur,ur,ur,ur,ur,ur,ur
ur,ug,ur,ur,cr,ug,ug,ug,ug,ur,ub,ux,ur,ur,ur,ur,ur,ur,ur,ur,ur,ur,ur
ur,ug,cg,ug,cr,ug,ug,ug,ug,cb,cr,ur,ur,ur,ur,ur,ur,ur,ur,ur,ur,ur,ur
ub,ur,ur,ug,ug,ug,ub,ub,ub,ub,ur,ur,ur,ur,ur,ur,ur,ur,ur,ur,ur,ur,ur
ux,ux,ug,ug,ug,ug,ub,ub,ub,ub,ur,ur,ur,ur,ur,ur,ur,ur,ur,ur,ur,ur,ur
ug,ur,ur,cr,cg,ub,ub,ub,ub,ub,ur,ur,ur,ub,ur,ur,ur,ur,ur,ur,ur,ur,ur
ug,ur,ug,ug,ug,ub,ug,ug,ux,ub,ux,ub,ub,cb,cb,ur,ur,ur,ux,ur,ur,ur,ur
ug,ur,ug,ub,ub,ub,ux,ug,ux,ub,ub,ub,ub,ub,cg,ur,ur,ur,ur,ur,ur,ur,ur
cg,ur,ug,ub,ub,ub,ug,ug,ug,ug,ug,ub,ub,ub,ug,ug,ur,ur,ur,ur,ur,ur,ur
ux,ur,ux,ug,ug,ub,ug,ug,ux,ux,ug,ux,ub,ub,cb,ur,ur,ur,ur,ur,ur,ur,ur
ur,ur,ug,ug,ug,ub,ub,ub,ub,ub,ub,ub,ub,ub,ub,ur,ub,ub,ub,cr,ur,ur,ur
ur,ur,ug,ug,ug,ug,ux,ug,ub,ug,ug,ug,ub,ub,ug,cr,ub,ub,ux,ub,ub,ur,ur
ur,ur,ur,ur,ur,ur,ur,ur,ub,ub,ub,ub,ub,ub,ub,ub,ub,ub,ub,ub,ub,ub,ur
ur,ux,ux,ux,ux,ux,ux,ub,ub,ub,ug,ub,ub,ub,ub,ub,ub,ub,ub,ux,ur,ub,ur
ur,ux,ux,ux,ux,ux,ux,ub,ug,ug,ug,ub,ux,ux,ub,ub,ub,ub,ub,ux,ub,ub,ur
ur,ur,ur,ur,ur,ub,ub,ub,ug,ug,ub,ub,ub,ub,ub,ub,ub,ub,ub,ub,ub,ux,cb
cg,ux,ux,ux,ux,ub,ux,ux,ux,ub,ux,ux,ux,ux,ux,ux,ux,ux,ub,ub,ux,ux,ux
cb,ux,ux,ux,ub,ub,ux,ux,ux,ub,ux,ux,ux,ux,ux,ux,ux,ux,ux,ux,ux,ux,ux
ux,ux,ub,ub,ub,ub,ub,ub,ub,ub,ux,ux,cg,ux,ux,ux,ux,ux,ux,ux,ux,cr,ub
ux,ux,ub,ub,ub,ub,cr,ux,cr,ub,cb,cg,cb,ux,ux,ux,cr,ux,ux,cr,ux,cr,cb