ur,ur,cr,ur,ur,ux,ur,cb,cb,cb,cg,cg,cg,ux,ux,ur,ur,ur,ur,ur,cb,cb,cb
ur,ur,ur,ur,ur,ur,ur,ux,ux,ux,ur,ux,ux,ux,ux,ur,ux,ur,ur,ur,ur,ur,ur
ur,cr,ur,ur,cr,ug,ur,ur,ur,ur,ur,ur,ur,ur,ur,ur,ur,ur,ur,ur,ur,ur,ur
cb,ur,ur,ur,cr,ug,ug,ug,ur,ur,ur,ur,ur,ub,ub,ub,ub,ub,ub,ur,ur,ur,ur
ur,ur,ur,ur,ur,cg,ug,ug,ug,ug,cg,ur,cr,ub,ub,ub,ub,ub,ub,ur,ur,ur,ur
ur,ur,ur,ur,ur,ur,ug,ur,ug,ub,ur,ur,ur,ur,ur,ug,ub,ub,ub,cr,ur,ur,ur
ur,ur,ur,cg,cr,ur,cg,ug,ug,ub,ub,cb,ur,ur,ug,ug,ur,ur,ub,ug,ur,ur,ur
ur,ur,ur,ug,ug,ug,ug,ug,ug,ug,ug,ur,ur,ug,ub,ub,ub,ub,ub,ug,ur,ur,ur
ur,ur,ur,ur,ur,ux,ur,ug,ug,ug,ug,ux,ub,ug,ug,ub,ub,ub,ug,ug,ur,ur,ur
ub,ux,ux,ux,ug,ux,ur,ug,ug,ug,ug,ub,ub,ug,ug,ug,ub,ub,ug,ug,ur,ur,ur
ub,ux,ux,ug,ug,ug,ug,ug,ug,ug,ug,ug,ug,ug,ug,ug,ub,ub,ub,ub,ub,ub,ub
ub,ux,ug,ug,ug,ug,ug,ug,ub,ub,ug,ub,ur,ug,ub,ug,ux,ux,ug,ug,ug,ug,ux
ub,ub,ub,ub,ub,ub,ub,ub,ub,ub,ub,ub,ub,ub,ub,ug,ug,ug,cg,ug,ux,ux,ux
cb,ub,ub,ux,ux,ug,ug,ug,ug,ub,ub,ug,ug,cr,ug,ug,ux,ug,ux,ug,ux,ux,ux
ub,ub,ub,ub,ub,ux,ug,ug,ug,ub,ub,ub,ub,ur,ug,ug,ux,ug,ug,ug,ux,ux,ux
ub,ub,ub,ub,ub,ux,ux,ux,ux,ub,ub,ub,ub,ub,ub,ub,ub,ux,ux,ux,ux,ux,ux
ub,ub,ux,ub,ub,ub,ux,ux,ux,ur,cr,ub,ub,cb,cb,ub,ub,ur,ur,ux,ux,ux,ux
ux,ux,ux,ux,ub,ub,ub,ub,ub,ur,ur,ux,ub,ur,ub,ub,ux,ux,ur,ux,ux,ux,ux
ux,ux,ub,ub,ub,ub,ub,ux,ux,ur,ur,ub,ub,cb,ux,ub,ux,ux,ur,ux,ux,ux,cb
cg,ux,ux,ux,ub,ux,ux,ux,ux,ur,ur,ux,ub,ub,ub,ub,ub,ub,ub,ub,ub,ub,ub
cb,ux,ux,ux,ux,ux,ux,ux,ub,ur,ur,ux,ub,ub,ub,ub,ub,ub,ub,ub,ub,ub,ub
ux,ux,ux,ux,ux,ux,ux,ux,ub,ur,ur,ux,cg,ub,ub,ub,ur,ur,ur,ux,ux,cr,cb
cb,ux,ux,ux,ux,ux,cr,ux,cr,ur,ur,cg,cb,ub,ub,ub,cr,ux,ux,cr,ux,cr,cb