ug,cr,cr,ur,ur,ur,ur,cb,cb,cb,cg,ur,cg,ur,ur,ur,ur,ur,ub,cb,cb,ur,cb
ug,ur,ur,ur,ur,ur,cr,ur,ur,ub,ub,ur,ur,ur,ur,ur,ur,ur,ub,ub,ur,ur,ur
ug,cr,ur,ur,ur,ug,ur,ub,cb,ub,ub,ur,ur,ur,ur,ur,ur,ur,ub,ub,ub,ub,ur
cg,ug,ug,ur,ur,cg,ur,ub,ub,cr,ur,ur,ur,ur,ug,ug,ug,ug,ug,ub,ub,ub,ub
ur,ur,ug,cg,ug,ug,ug,ug,ug,ur,ur,ur,ur,ug,ug,ur,ur,ub,ug,ub,ub,ub,ub
ur,ur,ur,ug,ug,ur,ur,ur,ub,ur,ug,ug,ug,ug,ub,ub,ub,ub,ug,ub,ub,ux,ub
ur,ur,ur,ur,ur,ur,ur,ur,ur,ur,ur,ur,ur,ub,ub,ub,ub,ub,ub,ub,ub,ub,ur
ur,ur,ur,ur,ur,ur,ur,ur,ur,ur,ur,ur,ur,cr,ur,cb,ub,ub,ub,ub,ub,ub,ur
ur,ur,ur,ur,ur,ur,ur,ur,ub,ur,ur,ur,ur,ur,ur,ur,ur,ur,ug,ug,ug,ur,ur
ur,cr,ux,ub,ub,ub,ub,ub,ub,ug,ug,ug,ub,ug,ux,ux,ux,ub,ug,ub,ug,ub,ur
ux,ux,ux,ub,ub,ub,ux,ur,ub,ux,ux,ug,ub,ug,ug,ux,ux,ub,ub,ub,ug,ub,ur
cg,ux,ug,cb,ub,ub,ug,ur,ub,ug,ug,ug,ug,ug,ug,ur,ur,ub,ub,ub,ug,ur,ur
ux,ux,ug,ux,ub,ub,ug,ur,ub,ug,ug,ux,ub,ub,ub,ub,ub,ub,ub,ub,ub,ub,ub
ux,ux,ug,ux,ub,ub,ug,ur,ug,ug,ug,ux,ub,ug,ug,ug,ub,cb,ub,ub,ub,ub,ub
ux,ux,ug,ug,ug,ug,ug,ur,ug,cg,ub,ub,ub,ux,ug,ug,ub,ub,ub,ub,ub,ub,ub
ux,ux,ux,ux,ug,ug,ug,ug,ug,ux,ux,ux,ub,ur,ur,ub,ub,ug,ug,ub,ub,ub,ub
ux,ux,ux,ug,ug,ux,ux,ur,ub,ux,ux,ux,ub,ub,ub,ub,ub,ux,ux,ux,ur,ur,ux
ux,ux,ux,ux,ux,ux,ux,ur,ub,ux,ux,ux,ux,ux,ux,ux,ub,ux,ux,ux,ur,ur,ux
ux,ux,ux,ux,ux,ux,ux,ur,ub,ux,ux,ux,ux,ux,ux,ux,ub,ux,ux,ux,ur,ur,cb
cg,ux,ux,ux,ux,ux,ux,ur,ub,ux,ux,ux,ux,ux,ux,ux,ub,ur,ur,ur,ur,ur,ur
cb,ux,ux,ux,ub,ub,ub,ur,ub,ub,ub,ub,ub,ub,ub,ub,ub,ux,ux,ux,ur,ur,ur
ux,ux,cr,ur,ur,ur,ur,ur,cb,ux,ux,ux,cg,ux,ux,ux,ur,ur,ur,ur,ur,cr,ur
cb,ub,ub,ub,ub,ux,cr,ux,cr,ux,cb,cg,cb,ux,ux,ux,cr,ux,ux,cr,ur,cr,cb