ur,ur,cr,ur,ur,cr,ur,cb,cb,cb,cg,cg,cg,ur,ur,ur,ur,ur,ur,ur,cb,cb,cb
ur,ur,ur,cr,ur,ur,ur,ur,ur,ux,ux,ux,ux,ur,ur,ur,ur,ur,ur,ur,ur,ur,ur
ur,cr,ug,ug,ur,ur,ur,ur,ur,ux,ux,ux,ux,ur,ur,ur,ur,ur,ur,ur,ur,ur,ur
cb,ur,cg,ur,ur,ur,ur,ur,ur,ur,ur,ur,ur,ur,ur,ur,ur,ur,ur,ur,ur,ur,ur
ur,ur,ur,ur,cg,ug,ur,ur,ur,ur,ur,ur,ur,ur,ur,ur,ur,ur,ur,ur,ur,ur,ur
ur,ur,ur,ur,ur,ug,cr,cb,cr,ur,ub,ub,ub,ub,ur,ur,ur,ur,ur,ur,ur,ur,ub
ur,ur,ur,ur,ur,ur,ur,ur,ur,ur,ub,ub,ub,ub,ur,ur,ur,ur,ur,ur,ur,ur,ub
ux,ur,ur,ur,ur,ur,ur,ur,ur,ur,ur,ur,ur,ur,ur,ur,ur,ur,ur,ux,ux,ur,ub
ux,ug,ug,ug,ur,ur,ur,ur,ur,ur,ur,ur,ub,ug,ug,ug,ur,ur,ur,ur,ur,ur,ub
ux,ux,ux,ug,cr,ur,ur,ur,ur,ur,ur,ug,ug,ug,cg,ug,ug,ug,ug,ux,ur,ur,ub
ux,ux,ux,ug,ur,ur,ur,ur,ur,ur,ur,ug,ug,ug,ug,ug,ug,ug,ug,ux,ur,ur,ub
ux,ux,ux,ub,ur,ur,ur,ur,ur,ug,ub,ub,ug,ug,ug,ug,cg,ug,ur,ur,ur,ur,ub
ux,ux,ux,ub,ub,ub,ub,ub,ub,ub,ub,ub,ug,ug,ug,ug,ug,ug,ug,ug,ug,ur,ub
ux,ux,ux,ux,ub,ux,ux,ub,ub,ug,ug,ug,ub,ub,ug,ug,ur,ug,ug,ur,ur,ur,ub
ux,ux,ur,ur,ub,ur,ur,ur,ub,ub,ub,ub,ug,ub,ub,ur,ur,ub,ux,ur,ur,ur,ub
ux,ux,ur,ux,ub,ux,cb,ub,ub,ub,ur,ux,ux,ub,ub,ub,ur,ub,ux,ur,ur,ur,ub
ux,ux,ux,ux,ub,ux,ub,ub,ub,ub,ur,ux,ux,ub,ub,ub,ur,ug,ub,ub,ur,ur,ub
ux,ux,ux,ux,ub,ux,ub,ub,ub,ub,ur,cr,ub,ub,ub,ub,ur,ub,ub,ub,ub,ur,ub
ux,ux,ux,ux,ub,ub,ub,ub,ub,ub,ur,ur,ur,ur,ur,ur,ur,ub,ub,ub,ub,ub,cb
cg,ux,ux,ux,ux,ux,ub,ub,ub,ub,ur,ub,ub,ub,ub,ug,ur,ur,ur,ur,ub,ur,ur
cb,ux,ux,ux,ux,ux,ux,ub,ux,ur,ur,cb,ub,ub,ub,cb,ub,ur,ub,ub,ub,cb,ur
ux,ux,ux,ux,ux,ux,ux,ub,ux,ur,ur,ur,cg,ub,ub,ub,ub,ur,ub,cg,ug,cr,cb
cb,ux,ux,ux,ux,ux,cr,ub,cr,ur,ur,cg,cb,ub,ub,ub,cr,ur,cr,cr,ug,cr,cb