ur,ur,cr,ur,ur,ur,ur,cb,cb,cb,cg,ug,cg,ub,ub,ub,ur,ur,ur,ur,cb,ur,cb
ur,ur,ur,ur,cr,cg,ur,ur,ur,ur,ur,cr,ug,ug,ug,cg,ur,ur,ur,ur,ux,ur,ur
ur,ur,ur,ur,ur,ug,ur,ur,ur,ub,ug,ug,ug,ug,ur,cb,ur,ur,ur,cr,ux,ub,ur
cb,ug,ur,ug,ug,ug,ur,ur,ur,ub,ub,ub,ug,ug,ur,ur,ur,ur,ux,ux,ux,ub,ur
ur,ug,cr,ug,ug,ug,ub,ub,ur,ub,ub,ur,cg,ug,ur,ur,ur,ur,ug,ug,ug,ub,cr
ur,ug,ug,ug,ug,ug,ub,ub,ub,ub,ub,ub,ug,ug,ur,ur,ug,ur,ur,ur,ur,ur,ub
ur,ug,ug,ug,ug,ur,ub,ub,ub,ub,ug,ub,cb,ug,ur,ug,ug,ur,ug,ug,ug,ub,cb
ur,ug,ug,cg,ux,ux,ub,ub,ub,ug,ug,ug,ug,ug,ub,ug,ug,ur,ug,ug,ug,ub,ur
ur,ur,ur,ub,ux,ux,ux,ux,ub,ub,ub,ug,ug,ug,ug,ug,ug,ur,ug,ug,ux,ub,ur
ur,ur,ur,ub,ux,ux,ux,ux,ux,ub,ub,ub,ug,ug,ug,ug,ug,ur,ug,ug,ux,ub,ur
ur,ur,ur,ub,ux,ux,ux,ux,ux,ub,ub,ub,ur,ug,ug,ug,ug,ug,ug,ug,ug,ub,cr
ur,ur,ur,ub,ub,ub,ub,ub,ub,ug,ub,ug,ug,ug,ug,ug,ug,ug,ug,ug,ug,ub,ug
ur,ur,ur,ux,ux,ux,ux,ux,ux,ug,ug,ug,ug,ug,ug,ug,ug,ug,ug,ug,ux,ub,ug
ur,ur,ur,ux,ux,ux,ux,ux,ux,ub,ux,ug,ux,ux,ux,ug,ug,ug,ur,ug,ux,ub,ux
ur,ur,ur,ux,ux,ux,ux,ux,ux,cb,ub,ug,cg,ug,ux,ug,ug,ug,ur,ug,ug,ub,ux
ur,ur,ur,ur,ur,ur,ub,ub,cr,ub,ub,ur,ur,ug,ug,ug,ug,ug,ur,ux,ux,ub,ux
ur,ur,ur,ur,ur,ur,ur,ur,ur,ub,ur,ur,ur,ur,ur,ur,ur,ur,ur,ux,ux,ub,ux
ur,ur,ur,ur,ur,ur,ur,ur,ur,ur,ur,ur,ur,ur,ur,ur,ur,ur,ur,ur,ur,ub,ux
ub,ub,ur,ub,ub,ux,ux,ub,ub,ur,ur,ur,ur,ur,ur,ur,ur,ur,ur,ur,ur,ub,cb
cg,ub,ub,ub,ub,ub,ub,ub,cb,ur,ur,ur,ur,ur,ur,ur,ur,ur,ur,ux,ur,ub,ub
cb,ub,ub,ub,ub,ur,ub,ub,ur,ur,ur,ur,ur,ur,ur,ur,ur,ux,ur,ur,ur,ub,ub
ux,ub,ub,ub,ub,ur,ux,ub,ub,ub,ux,ub,cg,ux,ug,ug,ur,ur,ur,ur,ur,cr,cb
ub,ur,ur,ur,ur,ur,cr,ub,cr,ux,ux,cg,cb,ux,ux,ux,cr,ux,ur,cr,ur,cr,cb