ur,ur,cr,ur,ur,ur,ur,cb,cb,cb,cg,cg,cg,ur,ur,ur,ur,ur,ur,ur,cb,cb,cb
ur,ur,ur,ur,ur,cr,ur,ur,ur,ur,ur,ur,ur,ur,ur,ur,ur,ur,ur,ur,ur,ur,ur
ur,cr,ur,ug,ug,cg,ur,ur,ur,ur,ur,ur,ur,ur,ur,ur,ur,ur,ur,ur,ur,ur,ur
cb,ur,ur,cr,ur,ur,ur,cr,ur,ur,ur,ug,ug,ub,ub,ub,cb,ur,ug,ux,ur,ur,ur
ur,ur,cb,cg,ur,ug,ug,cr,ur,ur,ur,ug,ug,ub,ub,ur,ur,ub,ub,ub,ux,ux,ur
ur,cr,ub,ug,ug,ug,ug,ug,ur,ug,ur,ug,ug,ub,ub,ur,ur,ub,ub,ub,ur,ux,ur
ur,ur,ub,ug,ug,ur,cg,ur,ug,ug,ug,ug,ub,ub,ub,ub,ub,ub,ub,ub,ur,ux,ur
ub,ur,ur,ug,ug,ur,ug,ug,ug,ug,ug,cg,ur,ub,ub,ub,ux,ub,ub,ub,ur,ux,ur
ub,ub,ug,ug,ur,ur,ug,ux,ux,ug,ur,ux,ub,ub,ub,ub,ub,ub,ux,ub,ur,ux,ur
ub,ub,ux,ux,ug,ur,ux,ux,ux,ug,ur,ub,ub,ub,cb,ub,ub,ux,ux,ub,ur,ur,ur
ub,ub,ub,ux,ug,ur,ug,ug,ug,ug,ur,ug,ug,ub,ub,ub,ub,ub,ub,ub,ub,ub,ub
ub,ub,ug,ug,ug,ur,ug,ug,ub,ub,ur,ub,ur,ub,ub,ub,ub,ub,ub,cb,ux,ux,ux
ub,ub,ub,ub,ub,ur,ub,ub,ub,ub,ur,ub,ub,ug,ub,ug,ug,ug,ub,cg,ux,ux,ux
ub,ub,ub,ux,ux,ur,ug,ug,ug,ub,ur,ug,ug,ug,ug,ug,ug,ug,ug,ug,ux,ux,ux
ub,ub,ub,ub,ub,ur,ug,ug,ug,ub,ur,ub,ub,ur,ug,ug,ux,ub,ub,ur,ux,ux,ux
ub,ub,ub,ub,ub,ur,ux,ux,ux,ub,ur,ub,ub,ub,ub,ub,ub,ub,ux,ur,ux,ux,ux
ub,ub,ux,ub,ub,ur,ux,ux,ux,ur,ur,ub,ub,ub,ub,ub,ub,ub,ub,ur,ux,ux,ux
ux,ux,ux,ux,ub,ur,ux,ux,ux,ur,ur,ux,ub,ub,ub,ub,ub,ub,ub,ur,ux,ux,ux
ux,ux,ub,ub,ub,ur,ux,ux,ux,ur,ur,ux,ub,ub,ub,ub,ub,ub,ub,ur,ux,ux,cb
cg,ux,ux,ux,ub,ur,ux,ux,ux,ur,ur,ub,ub,ub,ub,ub,ub,ub,ub,ur,cr,ub,ub
cb,ux,ux,ux,ux,ur,ux,ux,ux,ur,ur,cb,ub,ub,ub,ub,ub,ub,ub,ur,ur,ub,ub
ux,ux,ux,ux,ux,ur,ux,ux,ux,ur,ur,ux,cg,ub,ub,ub,ux,ux,ux,ur,ur,cr,cb
cb,ux,ux,cr,ur,ur,cr,ux,cr,ur,ur,cg,cb,ub,ub,ub,cr,ux,ux,cr,ur,cr,cb