cr,ub,cr,ub,ub,cb,ub,cb,cb,cb,ux,cg,cg,ug,ug,ug,ug,ug,ug,ug,cb,cb,cb
cr,cr,ur,ur,ur,ur,ur,ur,ur,cr,ur,ur,ur,ug,ur,ur,ur,ur,ur,ug,ux,ux,ux
cb,cr,ur,ur,ub,ur,ur,ur,ur,ur,ur,ux,ux,cg,ur,ur,ur,ur,ur,ug,ux,ux,ux
ub,cr,ub,ur,ub,ub,ub,ux,ux,ur,ur,ur,ur,ur,ur,ur,ux,ux,ux,ug,ux,ux,ux
ub,ub,ub,ux,ux,ux,ux,ux,ux,ur,ur,ur,ux,ux,ur,ux,ux,ux,ux,ug,ux,ux,ux
ur,ux,ur,ux,ux,ux,ux,ux,ux,ux,ux,ux,ux,ux,ur,ux,ux,ux,ux,ug,ux,ux,ux
ur,ux,ur,ux,ux,ux,ux,ux,ux,ux,ux,ux,ux,ux,ur,ux,ux,ux,ux,ug,ux,ux,ux
ur,ux,ur,ux,ux,ux,ux,ux,ux,ux,ux,ux,ux,ux,ur,ux,ux,ux,ux,ug,ux,ux,ux
ur,ur,ur,ur,ux,ux,ux,ux,ux,ux,ux,ux,ux,ux,cr,ux,ux,ux,ux,ug,ux,ux,ux
ug,ug,ug,ug,ug,ug,ug,ux,ux,cb,ub,ub,ub,ub,ub,ub,ux,ux,ux,ug,ux,ux,ux
ug,ur,ur,ur,ur,ux,ug,ux,ux,ux,ux,ux,ux,ux,ux,ub,ux,ux,ux,ug,ux,ux,ux
ug,ur,ur,ug,ug,ug,ug,ux,ug,ub,ub,ub,ub,ub,ub,ub,ug,ug,ug,ug,ux,ux,ux
ug,ub,cg,ug,ur,ur,ur,ux,ux,ub,ux,cr,ug,ub,ub,ug,ug,ug,ug,ug,ux,ux,ux
ug,ub,ug,ug,ug,ug,ug,ug,ug,ug,ug,ur,ub,ub,ub,ux,ux,ub,ub,ug,ux,ux,ux
cg,ub,ub,ub,ur,ug,ug,ug,ux,ub,ub,ur,ux,ux,ux,ux,ux,ub,ub,ub,ux,ux,ux
ur,cb,ur,ur,ur,ug,ug,ug,cg,ub,ub,ur,ux,ux,ux,ux,ux,ub,ub,ub,ux,ux,ux
ur,ur,ur,ur,ur,ur,ur,cr,ug,ug,ug,ur,ug,ug,ug,ug,ug,ub,ug,ub,ub,ux,ux
ug,ug,ux,ux,ux,cb,ub,ub,ub,ug,ub,ur,ux,cb,ub,ux,ub,ub,ux,ux,ub,ux,cg
ug,ug,ug,ug,ug,ub,ub,ug,ub,ux,ug,ur,ux,ub,ub,ub,ub,ux,ub,ub,ub,ux,cb
cg,ux,ug,ux,ux,ub,ub,ub,ub,ub,ub,ur,ux,ux,ux,ux,ub,ux,ub,ub,ub,ux,ux
cb,ux,ug,ug,ug,ug,ug,ug,ug,ug,ug,cg,ug,ux,ux,ux,ub,ux,ux,ux,ub,ux,ux
ux,ux,ux,ux,ux,ux,ur,ur,ur,ur,ur,ur,cg,ux,ux,ux,ub,ub,ub,ux,ux,cr,cb
cb,ux,ux,ux,ux,ux,cr,cb,cr,ux,ux,cg,cb,ux,ux,ux,ub,cb,ub,cr,ux,cr,cb