ur,ur,cr,ur,ur,ur,ur,cb,cb,cb,ur,cg,cg,ur,ur,ur,ur,ur,ur,ur,cb,cb,cb
ur,ur,ur,ur,ur,ur,ur,ur,ur,ur,ur,ur,ur,ur,ur,ur,ur,ur,ur,ur,ur,ur,ur
ur,cr,ur,ur,ur,ur,ur,ur,ur,ur,ur,ur,ur,ur,ur,ur,ur,ur,ur,cg,ug,ug,cr
ur,ur,ur,cb,ur,ur,ur,ur,ur,ur,ur,ur,ur,ur,ur,ur,ur,ur,ur,ur,ur,ur,ur
ur,ur,ur,ub,ur,ur,ur,ur,ur,ur,ur,ur,ur,ur,ur,ur,ur,cr,ur,ub,ur,ur,ur
cb,ur,ur,ub,ur,ur,ur,ur,ur,ur,ur,ur,ur,ur,ur,ur,ur,ug,ur,ur,ur,ur,ur
ub,ub,ub,ub,ur,ur,ur,ur,ur,ur,ur,ur,ur,ur,ur,ur,ur,ug,ur,ur,ur,ur,ur
ub,ur,ur,ur,ur,ur,ur,ur,ur,ur,ur,ur,ur,ur,ug,ug,cg,ug,ur,ur,ur,ur,ur
ub,ur,ur,ur,ur,ur,ur,ur,cg,ur,ur,ur,cr,cr,ug,ug,ug,ug,ug,ur,ur,ur,ur
ub,ur,ur,ub,ur,ur,ur,ur,cr,ur,ur,ur,ur,ug,ur,ur,ur,ur,ur,ur,ur,ur,ur
cb,ub,cr,cb,ur,ur,ur,ur,ub,ub,ur,ur,ur,ub,ub,ur,ur,ur,ur,ur,ur,ur,ur
ub,ub,ur,ur,ub,ur,ur,ur,ub,ub,ug,ur,ur,ub,ub,ur,ur,ur,ur,ur,ur,ub,ur
ur,ur,ur,ur,ur,ur,ur,ug,ub,ub,ub,ub,ub,ub,ub,ug,ug,ug,ug,ur,ub,ub,ur
ur,ur,ur,ur,ur,ur,ur,ug,ug,ug,ug,ug,ug,ur,cb,ur,ug,ug,ug,ug,ur,cg,ug
ur,ur,ur,ub,ub,ur,ur,ug,ug,ug,ug,ug,ug,ur,ug,ug,ug,ur,ug,ug,ug,ug,ug
ur,ur,ur,ub,ur,ur,ur,ug,ur,ur,ug,ug,ug,ur,ug,ug,ug,ug,ug,ug,ur,ug,ur
ur,ur,ur,ur,ur,ur,ur,ug,ur,ug,ug,ug,ug,ur,ug,ug,ur,ur,ur,ug,ub,ug,ur
ur,ur,ur,ur,ur,ur,ur,ug,ur,ug,ur,ug,ug,ur,ug,ug,ur,ub,ub,ub,ub,ug,ug
ur,ur,ur,ur,ur,ur,ur,ur,ur,ur,ur,ug,ug,ur,ug,ur,ur,ub,ub,ug,cr,ug,ur
cg,ur,ur,ur,ur,ur,ur,ur,ur,ur,ub,ur,ug,ur,ug,ur,ur,ur,ub,cb,ur,ub,ur
cb,ur,ur,ur,ur,ur,ur,ur,ur,ur,ur,ur,ug,ug,ug,ug,ug,ug,ug,ug,ug,ur,ur
ug,ur,ur,ur,ur,ur,ug,ug,ur,ur,ur,ur,cg,ur,ur,ur,ub,ur,ur,cg,ub,cr,cb
cb,ug,cg,ur,ur,ur,cr,cb,cr,ur,ur,cg,cb,ur,ur,ur,ub,ur,ur,cr,cb,cr,cb