ug,cr,cr,ug,ug,ug,ur,cb,cb,cb,ub,cg,cg,ur,ur,ur,ur,ur,ur,ur,cb,cb,cb
ug,ug,ug,ug,ug,ug,ug,ug,ug,ug,ug,ug,ug,ug,ug,ug,ug,ug,ug,ur,ub,ub,ug
ug,ug,ur,ub,ub,ub,ub,ub,ub,ub,ub,ur,ur,ur,ur,ub,ub,ub,ug,ur,ub,ub,ug
ug,ug,ug,ug,ug,cg,ur,ub,ub,ub,ub,ub,ub,ur,ur,ub,ub,ub,ug,ur,ub,ub,ug
ub,ub,ub,ub,ub,ub,ug,ub,ug,ug,ug,ug,ug,ur,ur,ug,ug,ug,ug,ur,ug,ur,ug
cb,ub,ub,ub,ub,ub,ub,cb,ub,ug,ub,ub,ub,ur,ur,ub,ub,ub,ub,cb,ub,ur,ug
cg,ub,ur,ub,ub,ub,ub,ub,ub,ub,ub,ub,ub,ur,ur,ur,ur,ur,ur,ub,ub,ur,ug
ub,ug,ur,ur,ug,ub,ub,ub,ub,ub,ub,ub,ub,ur,ug,ug,ug,ur,ur,ur,ub,ur,ug
ug,ug,ug,ug,ug,ub,ur,ub,ub,ub,ub,ub,ug,ur,ur,ur,ur,ur,ur,cb,ub,ur,ur
ug,ug,ur,ug,ug,ub,ub,ub,cb,ub,ub,ub,ub,ub,ub,ub,ub,ub,ub,ub,ub,ub,ur
ug,ug,ur,ug,ug,ub,ub,ub,ur,ub,ub,ub,ur,ug,cg,ub,ub,ub,ub,ur,ub,ub,ur
ug,ug,ug,ug,ug,ub,ub,ub,ub,ub,ub,ub,ub,ug,ur,ur,ub,ub,ub,ur,ub,ur,ur
ug,ug,ur,ug,ug,ur,ub,ub,ub,ub,ub,ub,ub,ug,cr,ub,ub,ug,ub,ur,ub,ub,ub
ug,ug,ug,ug,ug,ur,ub,ub,ub,ub,ub,ub,ub,ug,ug,ug,ug,ug,ub,ub,ur,ur,cb
ug,ug,ug,ug,ug,ur,ug,cg,ug,ug,ug,ug,ug,ug,ug,ug,ug,ug,ug,ug,ur,ug,ur
ug,ug,ur,ur,ug,ug,ug,ub,ug,ug,ur,ur,ur,ub,ub,ug,ug,ug,ub,ub,ur,ur,ur
ug,ug,ug,ug,ug,ub,ug,ug,ug,ur,ub,ub,ub,ub,ub,ur,ur,ub,ur,ug,ur,ur,ur
ug,ug,ur,ug,ug,ub,ug,ur,ub,ub,ub,ub,ub,ub,ug,ur,ur,ur,ur,ur,ur,ur,ur
ug,ug,ur,ug,ub,ub,ub,ub,ub,ub,ub,ub,ub,ub,ub,ur,ug,ug,ug,ug,cr,ur,ur
ug,ug,ur,ug,ur,ur,ub,ub,ub,ub,ub,ub,ub,ur,ur,ur,ur,cr,ur,ur,ur,ur,ur
cb,ug,ug,cg,ug,cb,ub,ug,ug,ug,ug,ub,ub,ub,ub,ub,ug,ug,ug,ug,ub,ur,cg
ug,ug,ug,ug,ug,ug,ug,ug,ug,ug,ug,ub,cg,ub,ub,ug,ug,ug,ug,ug,ub,cr,cb
cb,ug,ug,ug,ug,ug,cr,ug,ug,ug,ur,cg,cb,ub,ub,ub,ub,ub,ug,cr,ub,cr,cb