ur,ur,cr,ur,ur,ur,ur,cb,cb,cb,cg,ux,cg,ux,ub,ub,ux,ux,ux,cb,cb,ur,cb
ur,ur,cr,ur,ur,ur,ur,ub,ub,ub,ub,ub,cb,ur,ub,ub,ur,cb,ur,ur,ur,ur,cb
ur,ur,ug,ug,ur,cr,ur,ur,ur,ur,ur,ur,ur,ur,ub,ub,ub,ub,ur,ur,ur,ur,ur
cg,ur,cg,ug,ug,ug,ur,ur,ur,ur,ur,ur,ur,ur,ub,ur,ur,ur,ur,ur,ur,ur,ur
ur,ur,ur,ur,ug,ug,ur,ug,ug,ug,ug,ug,ub,ub,ub,ug,cr,ur,ur,ur,ur,ur,ur
ur,cr,cr,ur,ug,ug,ur,ur,ug,ur,ur,ug,ub,ub,ug,ug,cr,ur,ur,ur,ur,ur,ur
ur,ur,ur,ur,ug,ug,ug,ug,ug,cg,ub,ug,ug,ub,ug,ux,ux,ub,ub,ub,ub,ub,ur
ur,ur,ur,cg,ug,ug,ug,ug,ub,cb,ub,cg,ub,ub,ub,ub,ub,ub,ub,ub,ub,ub,ur
ur,ur,ur,ur,ur,ur,ug,ug,ub,ub,ub,ub,ub,ub,ux,ub,ub,ux,ub,ub,ux,ux,ur
ur,ur,ur,ur,ub,ux,ur,ug,ux,ub,ub,ub,ub,ub,ub,ub,ub,ux,ug,ug,ux,ux,ur
ux,ux,ux,ux,ub,ux,ur,ug,ug,ux,ub,ub,ub,ub,ub,ux,ug,ug,ug,cb,ux,ux,ur
ur,ur,ur,ur,ur,ur,ur,ur,ur,ur,cr,ub,ub,ub,ux,ug,ug,ug,ug,ub,ux,ux,ur
ur,ux,ub,ub,ub,ug,ur,ug,ug,ug,ug,ub,cb,ub,ug,ug,ug,ug,cg,ux,ux,ux,ur
ur,ux,ub,ub,ub,ug,ur,ug,ug,ug,ug,ug,ug,ug,ug,ug,ug,ug,ug,ux,ux,ux,ur
ur,ux,ub,ub,ub,ux,ux,ux,ub,ur,ub,ug,ug,ug,ug,ug,ug,ug,ug,ux,ux,ux,ur
ur,ux,ub,ub,ub,ur,ur,ur,ur,ur,ub,ux,ux,ub,ux,ux,ux,ux,ub,ux,ux,ux,ur
ur,ur,ur,ur,ur,ur,ur,ur,ur,ur,ur,ur,ur,ur,ur,ur,ur,ur,ur,ur,ur,ur,ur
ub,ub,ub,ub,ub,ux,ux,ux,ux,ux,ux,ux,ux,ub,ux,ux,ux,ur,ur,ur,ur,ur,ur
ub,ub,ub,ux,ub,ux,ux,ux,ux,ux,ux,ux,ux,ub,ux,ux,ux,ur,ur,ur,ur,ur,cb
cg,ub,ub,ux,ub,ux,ux,ux,ux,ux,ux,ux,ux,ub,ux,ux,ux,ur,ur,ur,ur,ur,ur
cb,ub,ub,ux,ub,ub,ub,ub,ub,ub,ub,ub,ub,ub,ux,ux,ux,ux,ur,ur,ur,ur,ur
ub,ub,ub,ub,ub,ux,ux,ux,ux,ux,ux,ux,cg,ux,ux,ux,ux,ux,ux,ux,ux,cr,ur
cb,ub,ub,ub,ub,ux,cr,ux,cr,ux,ux,cg,cb,ux,ux,ux,cr,ux,ux,cr,ux,cr,cb