ur,ur,cr,ur,ur,ur,ur,cb,cb,cb,ur,cg,cg,ur,ur,ur,ur,ur,ur,ur,cb,cb,cb
ur,ur,cb,ur,ur,ur,ur,ur,ur,ur,ur,ur,ur,ur,ur,ur,ur,ur,ur,ur,ur,ur,ur
ur,cr,ur,ur,ur,ur,ur,ur,ur,ur,ur,ur,ug,cg,ur,ur,ur,ur,ur,ur,ur,ur,ur
ur,ur,ur,ur,ur,ur,ur,cr,cb,ug,ug,ug,ug,ur,ur,ur,ur,ur,ur,ur,ur,ur,ur
ur,ur,ur,ur,ur,ur,ur,ur,ub,ub,ur,ur,ur,ug,ug,ug,ug,ug,ur,ur,ur,ur,ur
cb,ur,ur,ur,ur,cr,ur,cr,ur,ub,ur,ur,ur,ur,ur,ur,ur,ug,ug,ur,ur,ur,ur
ur,ur,ur,ur,ur,ur,ur,ub,ur,ub,ur,ur,ur,ur,ur,ur,ur,ug,ug,ur,ug,ur,ur
ur,ur,ur,ur,ur,ur,ur,cr,ub,ub,ug,ur,ur,ur,ur,ur,ur,ug,ug,ug,ug,ur,ur
ur,ur,ur,ur,ur,ur,ur,ur,cg,ur,ur,ur,ur,ur,ur,ur,ug,ug,ug,ug,ur,ur,ur
ur,ur,ur,ur,ur,ur,ur,ur,ur,ur,ur,cb,ub,ub,ub,ub,ur,ug,ug,ug,ur,ur,ur
ur,ur,ur,ur,ur,ur,ur,ur,ur,ur,cg,ur,ur,ub,ub,ub,ur,ug,ug,ug,ug,ug,ur
cr,ur,ur,ur,ub,ur,ur,ur,ur,ug,ug,ug,ub,ub,ub,ur,ur,ur,ug,ug,ur,ug,ur
ub,ur,ur,ug,cg,ur,ur,ur,ur,ur,cr,ug,ub,ub,ub,ub,ug,ur,ug,ur,ur,ur,ur
ub,ur,ur,ug,ug,ur,ur,ur,ur,ur,ub,ub,ub,ur,ub,ur,cg,ug,ug,ur,ur,ur,ur
ub,ur,ur,ug,ug,ur,ur,ur,ur,ur,ur,ur,ur,ur,ub,ur,ug,ur,ug,ur,ug,ur,ur
ub,ur,ur,ug,ug,ur,ur,ur,ur,ur,ur,ur,ur,ur,ur,ur,ug,ug,ug,ub,cr,ur,ur
ub,cb,ur,ug,ug,ur,ur,ur,ur,ur,ur,ur,ur,ur,ur,ug,ur,ur,cb,ub,ur,ur,ur
ur,ur,ur,ug,ug,ur,ur,ur,ur,ur,ur,ur,ur,ur,ug,ug,ur,ub,ub,ub,ur,ur,ur
ur,ur,ur,ug,ug,ur,ur,ur,ur,ur,ur,ur,ur,ur,ug,ur,ur,ub,ur,ub,ur,ur,ur
cg,ur,ur,ug,ug,ur,ur,ur,ur,ur,ub,ur,ug,ur,ug,ur,ur,ub,ur,ub,ur,ub,ur
cb,ur,ur,ug,ug,ur,ur,ur,ur,ur,ur,ur,ug,ur,ug,ug,ug,ub,ur,ub,ub,ub,ur
ug,ur,ur,ug,ug,ur,ug,ug,ur,ur,ur,ur,cg,ur,ur,ur,ur,ur,ur,ub,ub,cr,cb
cb,ug,cg,ur,ur,ur,cr,cb,cr,ur,ur,cg,cb,ur,ur,ur,ub,ub,ub,cr,cb,cr,cb