ur,ur,cr,ur,ur,ur,ur,cb,cb,cb,cg,ur,cg,ur,ur,ur,ur,ur,ur,cb,cb,ur,cb
cr,ur,ur,ur,ur,ur,ur,ur,ur,ur,ur,ur,ur,ur,ur,ur,ur,ur,ur,ur,ur,ur,ur
ur,cr,ub,ur,ur,ur,ur,ur,ur,ur,ur,ub,cr,ur,ur,ur,ur,ur,ur,ur,ur,ur,ur
cg,ur,ub,cg,ur,ur,ur,ur,ur,ur,ub,ub,ub,ur,ub,cr,ur,ur,ur,ur,ur,ur,ux
ur,ug,cb,ug,ur,ug,ug,ug,ug,ug,ug,cb,ub,ub,ub,ub,ub,ux,ux,ux,ux,ur,ux
ur,ug,cr,ur,ur,cg,ug,ub,ur,ur,ur,ug,ur,ux,ub,ub,ux,ux,ur,ur,ur,ur,ux
ug,ug,ug,ug,ug,ug,ug,ur,ur,ux,ux,ur,ur,ux,ux,ux,ug,ug,ur,ux,ux,ux,ux
ug,ug,ug,ur,ur,ug,ub,ub,ub,cb,ux,ur,ur,ur,ur,ur,ug,ug,ur,ub,ub,ub,ux
ub,ub,ub,ug,ug,ug,ub,ub,ub,ub,ur,ur,ug,ug,ug,ur,ug,ug,ur,ub,ub,ub,ux
ub,ub,ub,ub,ub,ub,ub,ub,ub,ub,ug,ur,ug,ug,ug,ur,ur,ur,ur,ub,ub,ub,ub
ub,ub,ub,ub,ub,ub,ub,ub,ub,cr,ur,ur,ub,ug,ug,ux,ux,ux,ux,cb,ub,ub,ux
cg,ub,ux,ub,ug,cg,ub,ub,ub,ub,ub,ug,ub,ug,ug,ug,ug,ux,ub,ub,ux,ux,ux
ub,ub,ug,cb,ub,ub,ub,ub,ub,ug,ug,ug,ub,ux,ug,ug,ug,ub,ub,ux,ux,ux,ux
ub,ub,ug,ug,ug,ug,ug,ub,ub,ub,ub,ur,ug,ug,ug,ug,ux,ux,ub,ub,ub,ub,ux
ub,ub,ug,ug,ub,ub,ub,ub,ub,ub,ub,ub,ur,ur,ur,cg,ur,ur,ur,ur,ur,ur,ur
ub,ub,ub,ub,ub,ub,ub,ub,ub,ub,ub,ub,ur,ur,ur,ug,ur,ur,ur,ur,ur,ur,ur
ur,ub,ub,ub,ub,ub,ub,ub,ub,ub,ug,cb,ug,ux,ug,ug,ux,ux,ux,ub,ub,ub,ux
ur,ub,ux,ug,ug,ug,ug,cb,ug,ug,ug,ur,ur,ur,ur,ux,ux,ux,ux,ux,ub,ux,ux
ur,ur,ur,ur,ur,ub,ur,ur,ur,ux,ub,ur,ur,ug,ur,ur,cr,ux,ux,ux,ux,ux,cb
cg,ur,ur,ur,ub,ub,ub,ur,ur,ux,ux,ur,ur,ur,ur,ur,ur,ur,ur,ur,ur,ur,ur
cb,ur,ux,ux,ub,ub,ub,ur,ux,ux,ux,ur,ur,ur,ur,ur,ur,ur,ur,ur,ur,ur,ur
ub,ub,ub,ub,ub,ub,ur,ur,ux,ux,ux,ux,cg,ux,ux,ux,ux,ux,ux,ux,ux,cr,ux
ub,ub,ub,ub,ub,ub,cr,ux,cr,ux,ux,cg,cb,ux,ux,ux,cr,ux,ux,cr,ux,cr,cb