cr,ur,cr,ur,ur,ur,ur,cb,cb,cb,ur,cg,cg,ur,ur,ur,ur,ur,ur,ur,cb,cb,cb
ur,ur,ur,ur,ur,ur,ur,ur,ur,ur,ur,ur,cb,ur,ug,ug,ug,cr,ur,ur,ug,ug,ux
ur,cr,cb,ur,ur,ur,ur,ur,ur,cr,ub,ub,ur,ur,ug,ug,ug,ug,ug,ux,ux,ug,ux
ur,ur,cr,ur,ur,ur,ur,ur,ur,ur,ur,ub,ub,ur,ub,ur,ur,ur,ur,ur,ur,ug,ur
ur,ur,ur,ur,ur,ur,ux,cr,ur,ur,ur,ur,cb,ur,ur,ur,ur,ur,ur,ur,ur,ug,ur
ub,ub,cr,ur,ur,ur,ux,ux,ux,ux,ux,ux,ux,ub,ux,ux,ux,ux,ux,ux,ux,cg,ux
ub,ub,ub,ur,ur,ur,ux,ux,ux,ux,ux,ux,ux,ux,ux,ux,ux,ux,ux,ux,ux,ux,ux
ux,ub,ux,ur,ub,ux,ux,ux,ux,ux,ux,ux,ux,ux,ux,ug,ug,ug,ux,ux,ux,ux,ux
ux,ux,ux,ur,ub,ub,ux,ux,ux,ux,ux,ux,ux,ur,ur,ug,ur,ug,ur,ur,ur,ug,ug
ux,ur,ur,ur,ur,ub,ux,ug,ug,ug,ub,ub,cb,ug,ug,ug,ux,ug,ug,ug,ug,ug,ug
ub,ub,ub,ub,ub,ub,ug,ug,ux,ux,ub,ux,ux,ux,ub,ub,ug,ug,ug,ux,ux,ur,ug
cb,ur,ur,ur,ur,ux,ux,ub,ub,ub,ub,cg,ug,ug,ug,ug,ug,ux,ug,ux,ux,ur,ug
ur,ur,ur,ux,ux,ux,ux,ub,ub,ub,ub,ub,ub,ub,ub,ub,ux,ux,ug,ux,ux,ur,ug
ur,ur,ux,ux,ux,ux,ux,ub,ub,ub,ub,cr,ur,ur,ur,ur,ur,ur,ur,ur,ur,ur,cg
ux,ux,ux,ux,ux,ux,ux,ub,ux,ug,ug,ug,ug,cg,ur,ur,ur,ur,ur,ur,ur,ur,ur
ux,ux,ux,ux,ux,ux,ux,ub,ug,ug,ug,ug,ur,ux,ux,ux,ux,ug,ug,ug,ug,ux,ux
ux,ux,ux,cg,ux,ux,ux,ub,ub,cb,ub,ub,ur,ux,ux,ux,ux,ug,ug,ug,ux,ux,ux
ux,ux,ux,ug,ug,ux,ux,ug,ux,ug,ux,ux,cr,ux,ux,ux,ux,ug,ur,ug,ux,ux,cg
ux,ux,ux,ug,ug,ug,ux,ug,ug,ug,ug,ux,ux,ux,ux,ux,ux,ug,ux,ug,ux,ux,cb
cg,ux,ux,ug,ug,ug,ux,ug,ug,ug,ux,ux,ux,ux,ux,ux,ux,ug,ug,ug,ux,ux,ux
cb,ux,ug,ug,ug,ug,ug,ug,ug,ug,ux,ux,ux,ux,ux,ux,ux,ux,ux,ur,ux,ux,ux
ux,ux,ug,ux,ux,ux,ux,ug,ug,ug,ux,ux,cg,ux,ux,ux,ux,ux,ux,ux,ux,cr,cb
cb,ux,ux,ux,ux,ux,cr,cb,cr,ux,ux,cg,cb,cb,ux,ux,ux,ux,ux,cr,ux,cr,cb