cr,ur,cr,cb,ub,ub,ur,cb,cb,cb,cg,cg,cg,ur,ur,ur,ur,ur,ur,ur,cb,cb,cb
ux,ur,ur,ur,ux,ur,ur,ur,ur,ur,ur,ur,cb,ur,ur,ur,ur,cr,ur,ur,ur,ur,ur
ux,cr,ur,ur,ux,ur,ur,ux,ux,ur,ur,ur,ur,ur,ur,ur,cr,ur,ur,ur,ur,ur,ur
ux,ux,ur,ur,ux,ux,ux,ux,ur,ur,ur,ur,ur,ur,ur,ur,ur,ub,ub,ub,ub,ux,ur
ur,ur,ur,ur,ur,ur,ur,ur,ur,ur,ur,ux,ux,ux,cr,cr,ux,ub,cb,ub,ux,ux,ur
ur,ur,ur,ur,ur,ur,ur,ur,ur,ux,ur,ur,ux,ug,ug,ug,ux,ur,ur,ur,ux,ux,ur
ux,ux,cg,ur,ux,ux,ux,ux,ux,ux,cr,ur,cg,ug,ux,ug,ub,ur,ur,ur,ur,ur,ur
ux,ux,ug,ur,cr,ux,ux,ux,ux,ux,ux,ur,ux,ux,ux,ug,ug,ug,ug,ug,ux,ux,ux
ux,ux,ug,ux,ux,ux,ux,ux,ux,ux,ug,ur,ug,ug,ug,ug,ug,ux,ug,ug,ux,ux,ux
ux,ug,ug,ux,ux,ug,ug,ug,ux,ux,ux,ur,ux,ux,ux,ux,ug,ug,ug,ug,ux,ux,ux
ux,ug,ug,ux,ux,ug,ug,ug,ug,cb,ug,ur,ux,ux,ux,ux,ux,ug,ug,ug,ux,ux,ux
ux,ug,ug,ux,ux,ug,cg,ug,ub,ub,ub,cb,ug,ux,ux,ux,ux,ug,ug,ug,ux,ux,ur
ux,ug,ug,ux,ux,ur,ur,ur,ur,cr,ub,ub,ug,ug,ug,ug,ug,ug,ug,ux,ux,ux,ur
ub,ub,ug,ub,ub,ur,ub,ub,ub,ub,cb,ur,ug,ug,ug,ug,ug,ux,ux,ux,ux,ux,ur
ub,ug,ug,ug,ug,ur,ub,ub,ub,ub,ub,cg,ub,ub,ug,ug,ug,ug,ug,ug,ux,ux,ur
ub,ug,ux,ub,ug,ur,ub,ub,ub,ub,ug,ug,ux,ux,ux,ug,ug,ug,ux,ug,ux,ux,ur
ux,ug,ux,ug,ug,ur,ub,ub,ub,ub,ug,ug,ur,ur,ur,ug,ug,cg,ur,ur,ur,ur,ur
ux,ug,ux,ug,ug,ur,ux,ux,ux,ub,ug,ug,ux,ux,ux,ug,ux,ux,ux,ux,ux,ux,ux
ux,ug,ux,ug,ug,ur,cb,ub,ub,ub,ux,ub,ux,ux,ux,ug,ux,ux,ux,ux,ux,ux,cb
cg,ug,ug,ug,ug,ur,ux,ux,ux,ub,ub,ub,ub,ub,ux,ux,ux,ux,ux,ux,ux,ux,ux
cb,ur,ur,ur,ur,ur,ux,ux,ux,ux,ux,ux,ux,ux,ux,ux,ux,ux,ux,ux,ux,ux,ux
ux,ur,ur,ug,ur,ur,ux,ux,ux,ux,ux,ux,cg,ux,ux,ux,ux,ux,ux,ux,ux,cr,cb
cb,ur,ur,ug,ur,ur,cr,cb,cr,ux,ux,cg,cb,ux,ux,ux,ux,ux,ux,cr,ux,cr,cb