ur,ur,cr,cr,ug,ur,ur,cb,cb,cb,cg,ur,cg,ur,ur,cb,ur,ur,ur,cb,cb,ur,cb
ur,ur,ur,ur,ug,ur,ur,ur,ur,ur,ur,ur,ur,ur,ux,ux,ur,ur,ur,ur,ur,ur,cb
ur,ur,ur,cr,cg,ur,ur,ur,ur,ur,ur,ur,ur,ur,ur,ur,ur,ur,ur,ur,ur,ur,ur
ug,ub,ug,ug,ur,cr,ur,ur,ur,ur,ur,ur,ur,ur,ur,ur,ur,ur,ur,ur,ur,ur,ur
ug,ub,ur,cb,ur,ug,ug,ur,ur,ur,ub,ur,ux,ur,ur,ur,ur,ur,ur,ur,ur,ur,ub
ug,ub,ub,ub,ug,ug,ug,ur,ug,ug,ug,ur,ux,ur,cg,ug,cr,ur,ur,ur,ur,ur,cr
ug,ug,ug,ug,ug,ug,ug,ux,ur,ur,ur,ub,ub,ug,ug,ug,ux,ur,ur,ur,ur,ur,ur
ug,ug,ug,ug,ug,ug,ug,ub,cb,ub,ub,ub,ub,ur,ug,ug,ur,ur,ub,ub,ub,cb,ur
ug,ux,ux,ub,ux,ug,ug,ub,ub,ux,ux,ux,ub,ur,ug,ug,ub,ub,ub,ub,ux,ur,ur
ug,ux,ux,ub,ux,ug,ug,ub,ub,ur,ur,ub,ub,ub,ub,ur,ub,ub,ub,ur,ur,cr,ur
ug,ux,ux,ug,ug,ug,ug,ub,ub,ub,ub,ub,ug,ug,ug,ux,ux,ux,ux,ur,ux,ux,ux
ug,ur,ug,ug,ug,ug,ug,ug,ur,ur,ur,ur,ug,ur,ug,ur,ur,ub,ub,ur,ur,ur,ux
ug,ub,ug,ub,ug,ug,ug,ug,ug,ug,ug,ug,ug,ug,cg,ug,ur,ub,ub,cb,ux,ur,ux
ug,ux,ug,ux,ug,ug,ug,ug,ug,ug,ug,ug,ux,ug,ub,ug,ub,ub,ub,ub,ur,ur,cg
cg,ux,ug,ux,ug,ug,ug,ug,ug,ug,ux,ug,ug,ug,ug,ug,ub,ub,ub,ur,ur,ur,ur
ub,ur,ug,ur,ug,ug,ug,ug,ug,ug,ug,ug,ux,ux,ux,ux,ub,ub,ub,ur,ur,ur,ur
ub,ux,ug,ux,ur,ur,ur,ux,ux,ux,ux,ux,ux,ux,ux,cr,ub,ub,ub,ub,ub,ub,ub
ub,ux,ug,ux,ub,ug,ug,ug,ug,ug,ug,ur,ur,ur,ur,ur,ur,ur,ur,ur,ur,ur,ur
ub,ub,ug,ux,ub,ug,ux,ux,ux,ux,cg,ux,ux,ux,ux,ux,ur,ur,ur,ur,ur,ur,ur
cg,ub,ug,ux,ub,ug,ux,ux,ux,ux,ux,ux,ux,ux,ux,ux,ur,ur,ur,ur,ur,ur,ur
cb,ub,ug,ug,ug,ug,ub,ub,ub,ub,ub,ub,ub,ub,ub,ub,ub,ub,cb,ur,ur,ur,ur
ub,ub,ub,ux,ub,ur,ux,ux,ux,ux,ux,ux,cg,ux,ux,ux,ux,ux,ux,ux,ux,cr,ur
ub,ub,ub,ur,ur,ur,cr,ux,cr,ux,ux,cg,cb,ux,ux,ux,cr,ux,ux,cr,ux,cr,cb