ur,ur,cr,ur,ub,ub,ur,cb,cb,cb,ur,ur,cg,ur,ur,cb,ux,ux,ux,cb,cb,ux,cb
ur,cr,ub,ur,ub,cb,ur,ur,ur,ur,ur,ur,ur,ur,ur,ur,ur,ur,ux,ux,cr,ux,cb
ur,ug,ub,ub,ub,ur,ur,ur,cg,ug,ug,cr,ur,ur,ur,ur,ux,ur,ur,ur,ur,ux,ux
ur,ug,ug,ur,ur,ur,ur,ur,ub,ur,ur,ur,cb,ur,cr,ub,ur,ur,ur,ux,ur,ux,ux
ur,ur,ug,ug,cg,ur,ur,ur,ub,ub,ub,ub,ub,ur,ur,ub,ub,ub,ub,ub,cb,ux,ux
ur,ur,cr,ug,ug,ur,ur,ur,ur,ur,ur,ur,ur,ur,ur,ur,ub,ub,ub,ux,ux,ux,ux
ur,ur,ur,ur,ur,ur,ux,ux,ux,ux,ur,ur,ur,ur,ur,ug,ug,ux,ux,ux,ux,ux,ux
ub,ux,ux,ux,ug,ux,ur,ug,ug,ug,ub,ub,ub,ub,ub,ux,ux,ux,ur,ur,ur,ur,ux
ub,ux,ux,ux,ug,ug,ug,ug,ux,ub,ub,ub,ub,ux,ub,ug,ug,ug,ug,ug,ug,ur,ux
ub,ux,ux,ux,ux,ux,ur,ur,ub,ub,ub,ub,ub,ub,ub,ug,ux,ug,ug,ug,ug,ur,ux
ub,ux,ux,ux,ux,ux,ug,ug,ub,ub,ub,ur,ub,ub,cb,ug,cg,ug,ug,ug,ug,ur,ux
ub,ub,ub,ub,ub,ub,ub,ug,ub,ub,ub,ub,ub,ug,ux,ug,ug,ug,ug,ug,ug,ux,ux
ub,ub,ub,ub,ub,ub,ub,ug,ub,ub,ub,ux,ux,ug,ug,ug,ug,ug,ug,ug,ug,ux,ux
ub,ux,ux,ux,ug,ug,ug,ug,ug,ug,ux,ux,ux,ux,ux,ur,ug,ug,ug,ug,ur,ur,cg
ub,ux,ux,ux,ug,ug,ug,ub,ub,ub,ub,ux,ux,ux,ux,ur,ur,ur,ux,ux,ux,ur,cr
ub,ux,ux,ux,ug,ug,ug,ug,ur,ub,ub,ug,ug,ug,ug,ur,cr,ug,ur,ur,ur,ur,ur
ub,ux,ux,ub,ub,ub,ub,ug,ux,ub,ub,ub,cb,ug,ug,ur,ug,ug,ur,ur,ur,ur,ur
ub,ub,ux,ub,ug,ux,ub,ub,ug,ub,ub,ub,ug,ug,ug,ur,ug,ug,ug,ug,ug,ur,ur
cg,ub,ux,ub,ug,ug,ug,ub,ub,ub,ub,ub,ub,ub,ug,ur,ug,ug,ug,ug,ug,ur,ur
cg,ub,ux,ub,ug,ug,ug,ux,ub,ub,ub,ur,ub,ub,ug,ur,ug,ug,ug,ug,ug,ur,ur
cb,ub,ux,ub,ux,ux,ur,ur,ur,ur,ub,ub,ub,ub,ur,ur,ur,ur,ur,ur,cg,ur,ur
ub,ub,ux,ub,ux,ux,ur,ur,ur,ur,ur,ur,cg,ur,ur,ur,ur,ur,ur,ur,ur,cr,ux
ub,ub,ub,ub,ux,ux,cr,ux,cr,ux,ux,cg,cb,ur,ur,ur,cr,ux,ux,cr,ur,cr,cb