ur,ur,cr,ur,ur,ur,ur,cb,cb,cb,cg,cg,cg,cb,ur,ur,ur,ur,ur,ur,cb,cb,cb
ur,ur,ur,ur,ur,ur,ur,cg,ux,ux,ux,ur,ur,ur,ur,ur,ur,cr,ug,ur,ur,ur,ur
ur,cr,ur,ur,ur,ur,ur,ur,ur,ur,ur,ur,ur,ur,ur,cr,ur,ur,cg,ur,ur,ur,ur
cb,ur,ur,ur,ur,ur,ur,ur,ur,ur,ur,ur,ur,ur,ur,ur,ur,ur,ur,ur,ur,ur,ur
ur,ur,ur,ur,ur,ur,ur,ur,ur,ur,ur,ur,ur,ur,ur,ur,cr,ur,ur,ur,ur,ur,ur
ur,ur,ur,ur,ur,ur,ur,ur,ur,ur,ur,ur,ur,cr,ug,ur,ur,ur,ug,ur,ur,ur,ur
ur,ur,ur,ur,ur,ur,ur,ur,ur,ur,ur,ur,ur,ur,ur,ur,ug,ug,ug,ur,ur,ur,ur
ur,ur,ur,ur,ur,ur,ur,cg,ug,ug,ug,ug,cr,ur,ur,ur,ug,ug,ug,ur,ur,ur,ur
ur,ur,ur,ur,ur,ur,ug,ug,ur,ur,ur,ur,ur,ur,ur,ur,ur,cg,ug,ur,ur,ur,ur
ur,ur,ur,ur,ug,ug,ug,ur,ur,ub,ub,ub,ub,ub,ub,ub,ur,ur,ur,ug,ur,ur,ur
ur,ur,ur,ur,ug,ug,ug,ug,ug,ug,ub,ub,ub,ub,ub,ub,ur,ur,ur,ur,ur,ur,ug
ur,ux,ux,ug,ug,ug,ug,ug,ug,ug,ug,cb,ub,ub,ub,ub,ur,ur,ur,ur,ux,ux,ux
ur,ux,ux,ug,ug,ug,ug,ur,ur,ur,ug,ug,ur,ug,ub,ug,ug,ug,ug,ux,ux,ux,ux
ur,ux,ux,ug,ug,ur,ug,ug,ur,ur,cb,ug,ur,ug,ub,ub,ub,ub,ub,cb,ub,ux,ux
ur,ux,ux,ux,ug,ur,cg,ug,ur,ur,ub,ub,ur,ug,ug,ug,ug,ub,ub,ub,ub,ux,ux
ur,ux,ux,ux,ug,ug,ur,ug,ur,ub,ub,ub,ur,ub,ub,ug,ug,ug,ub,ub,ub,ux,ux
ur,ux,ux,ux,ux,ur,ur,ug,ur,ur,ug,ug,ur,ux,ux,ux,ux,ug,ux,ux,ux,ux,ux
ur,ub,ub,ux,ux,ur,cr,ur,ur,ur,ug,ur,ur,ur,cr,ug,ug,ug,ux,ux,ux,ux,ux
ur,ur,ur,ur,ur,ur,ur,ur,ur,ur,ux,ur,ux,ux,ux,ux,ux,ux,ux,ux,ux,ux,cb
cg,ux,ux,ux,ux,ur,ur,ur,ur,ur,ux,ur,ur,ur,ur,ur,ur,ur,ur,ur,ur,ur,ur
cb,ux,ux,ux,ux,ur,ur,ur,ur,ur,ur,ur,ur,ur,ur,ur,ur,ur,ur,ur,ur,ur,ur
ur,ur,ur,ur,ur,ur,ur,ur,ur,ux,ux,ux,cg,ux,ux,ux,cb,ux,ux,ux,ux,cr,cb
cb,ur,ur,ur,ur,ur,cr,cb,cr,ux,ux,cg,cb,ux,ux,ux,cr,ux,ux,cr,ux,cr,cb