cr,ux,cr,ur,cb,ub,ub,cb,cb,cb,cg,cg,cg,ur,ur,ub,cb,ur,ur,ur,cb,cb,cb
ur,ur,ur,ur,ur,ur,ur,ur,ug,ug,ug,ur,ur,ur,ur,ub,cr,ur,ur,ur,ur,ur,ur
cg,cr,ur,ur,cg,ur,ur,ug,ug,ux,ug,ux,cr,ur,ur,ur,cr,ux,ub,ur,ur,ur,ur
ug,ug,ug,ug,ug,ur,ur,ur,ur,ur,ug,ux,ur,ur,ur,ub,ub,ux,ux,ux,ux,ux,ux
ur,ur,ur,ug,ug,ur,ur,ur,ur,ur,ur,ur,ur,ur,ur,ux,ux,ux,ux,ux,ux,ux,ux
ur,ug,ug,ug,ug,ug,ux,ux,ux,ur,ur,ur,ur,cr,ug,ug,cg,ux,ux,ux,ux,ux,ux
ur,ur,ux,ux,ug,ug,ux,ux,ux,ux,ux,ux,ux,ux,ub,ux,ur,ux,ux,ux,ux,ux,ur
ur,cr,ub,ux,ug,ug,ux,ux,ux,ux,ux,ur,cr,ux,ub,ux,ur,ux,ux,ux,ux,ux,ur
ub,ub,ux,ux,ug,ug,ux,ux,ub,ub,cb,ur,ux,ux,ug,ug,ur,ux,ux,ux,ux,ux,ur
ub,ux,ux,ux,ug,ug,ux,ux,ub,ub,ub,ur,ug,ug,ug,ug,ux,ux,ub,ux,ux,ux,ur
ub,ux,ux,ux,ug,ug,ux,ux,ub,ub,ub,ur,ub,ub,cb,ub,ug,ub,ub,ub,ux,ux,ur
ub,ux,ux,ux,ug,ug,ux,ux,ub,ub,ub,ur,ug,ug,ug,ub,ug,ux,ux,ub,ub,ub,ur
ub,ux,ux,ux,ug,ug,ux,ub,ub,ux,ub,ur,ub,ug,ub,ub,ub,ub,ux,ux,ub,ux,ur
ub,ux,ux,ux,ug,ug,ub,ub,ub,ub,ub,ur,ub,ug,cg,ux,ux,ub,ux,ux,ub,ux,ur
ub,ux,ux,ub,ug,ug,ub,ux,ub,ub,ub,ur,ub,ub,cb,ub,ub,ub,ux,ux,ub,ux,ur
ub,ub,ub,ub,ug,ug,ub,ub,ub,ub,ub,cb,ur,ur,ur,ur,ur,cg,ur,ur,ur,ur,ur
ug,ux,ub,ux,ug,ug,ux,ux,ub,ux,ux,ux,ux,ux,ux,ux,ug,ug,ux,ux,ux,ux,ux
ug,ux,ub,ub,ug,ug,ux,ux,ub,ux,ux,ux,ux,ux,ux,ux,ug,ug,ug,ug,ug,ug,ug
ug,ug,ug,ub,ub,ub,ug,ug,ug,ug,ux,ux,ux,ux,ux,ux,ux,ux,ux,ux,ux,ux,cb
cg,ux,ux,ux,ub,ub,ux,ux,ux,ux,ux,ux,ux,ux,ux,ux,ux,ux,ux,cr,ur,ur,ur
cb,ub,ub,ub,ub,ur,ur,ur,ur,ur,ur,ur,ur,ur,ur,ur,ur,ur,ur,ur,ur,ur,ur
ux,cb,ux,ux,ux,ur,ux,ux,ux,ux,ux,ux,cg,ux,ux,ux,ux,ux,ux,ux,ux,cr,cb
cb,ur,ur,ur,ur,ur,cr,cb,cr,ux,ux,cg,cb,ux,ux,ux,ux,ux,ux,cr,ux,cr,cb