ur,ur,cr,ur,ur,ur,ur,cb,cb,cb,cg,ur,cg,ur,ur,ur,ur,ur,ur,cb,cb,ur,cb
ur,ur,ur,ug,ug,ug,ug,ur,ur,ur,ur,ur,ur,ur,ur,ur,ur,ur,ur,ur,ur,ur,ur
ur,ur,ur,cg,cr,ug,ug,ur,ur,ur,ur,ur,ur,cr,ur,ur,ur,ur,ur,ur,ur,ur,ur
cg,ur,ur,ur,ur,ug,ur,ur,ur,ur,ur,cr,ub,ub,ur,ur,ur,ur,ur,ur,ur,ur,ur
ur,ur,ug,ur,ug,cg,ur,ur,ur,cr,ux,ux,ub,ub,cb,ur,ur,cr,ur,ur,ur,ur,ur
ur,ur,ug,ur,ur,ug,ur,ur,ur,ug,ug,ug,ub,ux,ur,ur,ur,ux,ux,ux,ux,ux,ux
ur,ur,ug,ug,ug,ug,ur,ux,ux,ur,ux,ux,ub,ux,ux,ub,ur,ub,ub,ub,ub,ub,ur
ur,ux,ug,ug,ug,ur,ur,ur,ur,ur,ux,ux,ub,ub,ub,ub,ur,ub,ub,ub,ub,ub,ur
ur,ur,ur,ur,ur,ur,cg,ug,ub,ub,ux,ux,ux,ub,ux,ub,ur,ux,ux,ux,ux,ux,ux
ur,ur,ug,ug,ug,ug,ug,ub,ub,ub,ub,ub,ub,ub,ub,ub,ur,ux,ux,ux,ux,ux,ux
ur,ur,ug,ug,ug,ug,ug,ug,ux,ub,ub,ur,ub,ub,ub,ub,ur,ur,ur,ur,ur,ur,ur
cg,cb,ub,ub,ub,ub,ub,ub,ub,ub,ug,ug,ug,ub,ub,ub,ub,ub,ub,ub,ub,ub,ur
ur,ur,ur,ug,ub,ub,ug,ug,ub,ub,ux,ug,cg,ug,cb,ug,ug,ub,ub,ub,ub,ub,ur
ur,ur,ur,ub,ub,ub,ub,ug,ug,ub,ux,ug,ug,ug,ub,ug,ug,ug,ub,ub,ux,ub,ur
ux,ub,ub,ub,ub,ug,ug,ug,ub,ub,ug,ug,ug,ug,ux,ug,ug,ug,ub,ub,ux,ub,ur
ux,ub,ur,ur,ub,ug,ub,ub,ub,ub,ub,ub,ub,ub,ub,ug,ug,ux,ux,ux,ux,ub,ur
ux,ub,ur,ub,ub,ux,ux,ur,ub,ur,ux,cr,ur,ur,ub,ub,ub,ub,ub,ub,ub,ub,ur
ux,ub,ur,ub,ur,ur,ur,ur,ur,ur,ub,ub,ub,ur,cb,cb,ur,ur,ur,ur,ur,ur,ur
ux,ub,ur,ub,ub,ub,ub,ub,ub,ux,cr,ur,ur,ur,ux,ux,ux,ux,ux,ux,ux,ux,cb
cg,ub,ub,ub,ub,ur,ux,ur,ub,ux,ub,ub,ux,ux,ux,ux,ux,ux,ux,ux,ux,ux,ux
cb,ur,ur,ur,ub,ux,ux,ur,ub,ux,ub,ub,ux,ux,ux,ux,ux,ux,ux,ux,ux,ux,ux
ur,ur,ur,ur,ub,ur,ur,ur,cb,ux,ub,ub,cg,ux,ux,ux,ux,ux,ux,ux,ux,cr,ux
ur,ur,ur,ub,ub,ux,cr,ux,cr,ux,cb,cg,cb,ux,ux,ux,cr,ux,ux,cr,ux,cr,cb