cr,ub,cr,ub,ub,ub,cb,cb,cb,cb,ux,cg,cg,ug,ug,ug,ug,ug,ug,ug,cb,cb,cb
cr,cr,cr,ur,ur,ur,ur,ur,ur,ur,ur,ur,ur,ug,ur,ur,ur,ur,ur,ug,ux,ux,ux
cb,cr,ur,ur,ux,ux,ux,ux,ux,ux,ux,ux,ux,ug,ur,ur,ur,ur,ur,ug,ux,ux,ux
ub,cr,ub,ur,ux,ux,ux,ux,ux,ux,ux,ux,ux,ug,ur,ur,ux,ux,ux,ug,ux,ux,ux
ub,ub,ub,ux,ux,ux,ux,ux,ux,ux,ux,ux,ux,ug,ur,ux,ux,ux,ux,ug,ux,ux,ux
ur,ux,ur,ux,ux,ux,ux,ux,ux,ux,ux,ur,ur,ur,ur,ux,ux,ux,ux,ug,ux,ux,ux
ur,ux,ur,ux,ux,ux,ux,ux,ux,ux,cg,ur,ux,ur,ur,ux,ux,ux,ux,ug,ux,ux,ux
ur,ux,ur,ux,ug,ug,ug,ug,ug,ug,ug,ur,ux,ur,ur,ux,ux,ux,ux,ug,ux,ux,ux
ur,ux,ur,ux,ug,ux,ux,ux,cb,ub,ub,ub,ux,ur,ur,ux,ux,ux,ux,ug,ux,ux,ux
ug,ug,ug,ug,ug,ug,ug,ub,ub,ub,ub,ub,ub,ur,ur,ub,ux,ux,ux,ux,ux,ux,ux
ug,ur,ug,ug,ug,ux,ug,ub,ub,ub,ub,ub,ub,cr,ur,ub,ux,ux,ux,ux,ux,ux,ux
ug,ur,ug,ug,ug,ug,ug,ux,ux,ub,ub,ur,ub,ug,ur,ub,ux,ux,ux,ux,ux,ux,ux
ug,ub,ug,ux,ux,ux,ux,ux,ux,ux,ux,ur,ug,ug,ur,ug,ug,ux,ux,ux,ux,ux,ux
ug,ub,ug,ug,ug,ug,ug,ug,ug,ug,ug,ur,ux,ug,ur,ux,ux,ub,ub,ux,ux,ux,ux
ug,ub,ub,ub,ux,ug,ug,ug,ux,ux,ux,cg,ug,ug,ur,ur,ur,ur,ur,ur,ur,ur,cr
ub,ub,cb,ub,ux,ug,ug,ug,ug,ug,ug,ug,ug,ug,ug,ug,ug,ub,ux,ux,ux,ux,ux
ub,ub,ur,ub,ug,ug,ur,ur,ur,ur,ur,ur,ur,ur,ur,ur,ur,ur,ur,ur,cr,ux,ux
ux,ub,ux,cb,ux,ug,ug,ug,ug,ug,ub,ub,ub,ub,ub,ux,ug,ug,cg,ux,ux,ux,cg
ux,ux,ug,ub,ux,ub,ub,ux,ug,ux,ub,ub,ux,ub,ub,ub,ug,ug,ux,ux,ux,ux,cb
cg,ux,ug,ub,ub,ub,ub,ub,ug,ub,ub,ub,ux,ux,ux,ux,ux,ux,ux,ux,ux,ux,ux
cb,ux,ug,ug,ug,ub,ug,cb,cg,ub,ug,cg,ug,ux,ux,ux,ux,ux,ux,ux,ux,ux,ux
ux,ux,ux,ux,ux,ub,ur,ur,ur,ub,ug,ub,cg,ux,cb,ux,ub,ub,ub,ux,ux,cr,cb
cb,ux,ux,ux,ux,ub,cr,cb,cr,ug,ug,cg,cb,ux,ub,ub,ub,ub,ub,cr,ux,cr,cb