ur,ur,cr,ur,ur,ur,ur,cb,cb,cb,ur,ur,cg,ur,ur,cb,ur,ur,ur,cb,cb,ux,cb
ur,ur,ur,ur,ur,ur,ur,ur,ur,cr,ur,ur,ur,ur,ur,ub,ub,ub,ur,ur,ux,ux,cb
ur,ur,ug,cg,ur,ur,ur,ur,cb,ub,ur,ur,ub,ub,ub,ur,ur,ub,ur,ur,ux,ux,ux
ur,cr,ug,cr,ur,ur,ur,ur,ur,ur,ur,cr,cb,ur,ub,ur,ur,ub,ur,ub,ux,ux,ux
ur,ur,ug,ug,ug,ur,ur,ur,ub,ur,ur,ur,cr,ur,ub,ur,ub,ub,ub,ux,ux,ux,ux
ux,cg,ug,ug,ug,ug,ur,ur,ux,ur,ub,ug,ux,ur,ub,ur,ub,ub,ub,ub,ub,ub,ux
ux,ux,ur,ug,ug,ux,ur,ur,ur,ur,ub,ub,ub,ub,ub,ug,ug,ub,ux,ux,ub,ub,ux
ux,ux,ux,ux,ug,ur,ur,ug,ug,ug,ug,ub,ub,ub,ub,ub,ug,ur,ur,ur,ur,ur,ux
ux,ux,ux,ur,ug,ug,ug,ug,ur,ur,cb,ub,ub,ur,ub,ur,ux,ur,ux,ux,ux,ur,ux
ur,ur,ur,ur,ux,ux,ur,ur,ug,ug,ug,ub,ub,ub,ub,ur,ur,ug,ug,ug,ux,ur,ux
ur,ur,ur,ux,ur,ur,ug,ug,ug,ub,ub,ur,ub,ub,ux,ug,ug,ug,ug,ug,ur,ur,ub
ur,ur,ur,ur,ur,ug,ug,ug,ug,ug,ub,ub,ub,ug,ux,ug,ug,ug,ug,ug,ux,ux,ub
cb,ur,ur,ur,ug,ug,ug,ug,ug,ug,ub,ug,ub,ug,ug,ug,ug,ug,ug,ux,ux,ux,ux
ub,ur,ur,ur,ug,ug,ug,ug,ug,ug,ug,ug,ug,ug,ub,ur,ug,cg,ur,ur,ur,ur,cg
ub,ur,ux,ur,ug,ug,ug,ub,ub,ug,ux,ux,ux,ux,ub,ur,ur,ur,ux,ux,ux,ur,cr
ub,ur,ur,ur,ug,ug,ug,ug,ur,ug,ug,ug,ug,ug,ug,cg,ur,ur,ur,ur,ur,ur,ur
ub,ur,ur,ub,ub,ub,ub,ug,ub,ub,ub,ur,ur,ur,ur,ur,ur,ur,ur,ur,cr,ub,ur
ub,ub,ux,ub,ug,ub,ub,ub,ug,ug,ug,ur,ub,ub,ub,ux,ub,ub,ub,ub,ub,ub,ur
cg,ub,ux,ub,ug,ug,ug,ub,ub,ub,ub,ur,ub,ub,ub,ub,ub,ux,ub,ub,ub,ub,ur
cg,ub,ur,ub,ug,ug,ug,ur,ub,ub,ub,ur,ub,cb,ub,ub,ux,ux,ux,ub,ub,ub,ur
cb,ub,ux,ub,ux,ur,ur,ur,ur,ur,ur,ur,ur,ur,ur,ur,ur,ur,ur,ur,ur,ur,ur
ub,ub,ux,ub,ux,ur,ur,ur,ur,ur,ur,ur,cg,ub,ub,ub,ub,ub,ub,ub,ub,cr,ux
ub,ub,ub,ub,ur,ur,cr,ux,cr,ux,ux,cg,cb,ub,ub,ux,cr,ux,ux,cr,ux,cr,cb