ur,ur,cr,ur,ur,ur,ur,cb,cb,cb,ur,cg,cg,ur,ur,ur,ur,ur,ur,ur,cb,cb,cb
ur,ur,ur,ur,ur,ur,ur,ur,ur,ur,ur,ur,ur,ur,ur,ur,ur,ur,ur,ur,ur,ur,ur
ur,cr,ur,ur,ur,ur,ur,ur,ur,ur,cg,ug,ug,ug,ug,ug,ug,ug,ug,cr,ur,ur,ur
ub,ub,ub,ub,ub,ub,ur,ur,ur,ur,ur,ur,ur,ur,ur,ur,ur,ur,ur,ur,ur,ur,ur
ur,ur,ur,ub,ur,cb,ur,ur,ur,ur,ur,ur,ur,ur,ur,ur,ur,ur,ur,ub,ur,ur,ur
cb,ur,ur,ub,ur,ur,ur,ur,ur,ur,ur,ur,ur,ur,ur,ur,ur,ur,ur,ur,ur,ur,ur
ub,ub,cb,ub,ur,ur,ur,ur,ur,ur,ur,ur,ur,ur,ur,ur,cg,ug,ur,ur,ur,ur,ur
ub,ur,ub,ur,ur,ur,ur,ur,ur,ur,ur,ur,ur,ur,ur,ur,ur,ug,ug,ur,ur,ur,ur
ub,ur,ub,ur,ur,ur,ur,ur,cg,ur,ur,ur,ur,ur,ug,ug,ur,ur,ug,ur,ur,ur,ur
ub,cr,ur,ub,ur,ur,ur,ur,ur,ur,ur,ur,ur,ur,ur,cr,cr,ur,ug,ur,ur,ur,ur
cb,ur,ub,ub,ur,ur,ur,ur,ur,ub,ur,ur,ur,ur,ub,ur,ur,ur,ur,cg,ug,ug,ur
ub,ur,ub,ur,ub,ur,ur,ur,ur,ur,ur,ur,ur,ur,ur,ur,ur,ur,ur,ur,ur,ug,ur
ur,ur,ur,ur,ur,ur,ur,ug,cr,ur,ub,ub,ub,ub,ur,ug,ug,ug,ug,ug,ug,ug,ur
ur,ur,ur,ur,ur,ur,ur,ug,ug,ub,ub,cr,ur,ur,ur,ur,ug,ug,ug,ur,ur,ur,ug
ur,ur,ur,ub,ub,ur,ur,ug,ug,ub,ub,ub,cb,ur,ug,ug,ug,ur,ug,ur,ug,cr,ug
ur,ur,ur,ub,ur,ur,ur,ug,ur,ur,ug,ug,ug,ur,ug,ug,ug,ug,ug,ur,ur,ug,ur
ur,ur,ur,ur,ur,ur,ur,ug,ur,ug,ug,ug,ug,ur,ug,ug,ur,ur,ur,ur,ur,ug,ur
ur,ur,ur,ur,ur,ur,ur,ug,ur,ug,ur,ug,ug,ur,ug,ug,ur,ub,ub,ub,ur,ug,ug
ur,ur,ur,ur,ur,ur,ur,ur,ur,ur,ur,ug,ug,cg,ug,ur,ur,ub,ub,ug,ur,ug,ur
cg,ur,ur,ur,ur,ur,ur,ur,ur,ur,ub,ur,ug,ug,ug,ur,ur,ur,ub,ub,ur,ub,ur
cb,ur,ur,ur,ur,ur,ur,ur,ur,ur,ur,ur,ug,ug,ug,ug,ug,ub,ub,ug,ug,ur,ur
ug,ur,ur,ur,ur,ur,ug,ug,ur,ur,ur,ur,cg,ug,ug,ug,ub,ub,ug,ug,ub,cr,cb
cb,ug,cg,ur,ur,ur,cr,cb,cr,ur,ur,cg,cb,ur,ur,ur,ub,cb,ur,cr,cb,cr,cb