cr,ur,cr,cr,ub,cb,ur,cb,cb,cb,cg,cg,cg,ur,ur,ur,ur,ur,ur,ur,cb,cb,cb
cg,ur,ur,ur,ur,ur,ur,ur,ur,ur,ur,ux,ur,ur,ur,ux,ux,cr,ur,ur,ur,ur,ur
ur,cr,ur,ur,ur,ur,ur,ur,ur,ux,ur,ux,ur,ux,ur,ux,ux,ur,ur,ur,ur,ur,ur
ur,ux,ur,ur,cr,ur,ur,ur,ux,ux,ur,ug,ug,ux,ur,ur,ur,ur,ur,ur,ur,ur,ur
ug,ug,ug,ug,ug,ur,ur,ur,ur,ur,ur,ug,ug,ux,ux,ux,ux,ur,ur,ur,ur,ur,ur
ug,ur,ur,ur,ur,ur,ur,ur,ur,cr,ug,ug,ug,ux,ux,ux,ux,ur,cr,ur,ur,ur,ur
ug,ur,ur,ux,ux,ux,ux,ux,ux,ur,ug,ug,ug,ux,ux,ux,ux,ur,ux,ux,cr,ur,ur
ug,ug,ug,cg,ux,ux,ux,ux,ux,ur,ug,ur,cg,ur,ur,cb,ur,ur,ux,ux,ux,ux,ur
ux,ux,ux,ux,ux,ux,ux,ux,ux,ur,ub,ug,ug,ub,ub,ub,ux,ux,ux,ux,ux,ux,ur
ux,ux,ux,ux,ux,ux,ux,ux,ux,ub,ub,ug,ug,ub,ub,ub,ux,ux,ux,cr,ux,ux,ur
ux,ux,ux,ux,ur,ux,ux,ug,ug,ub,ub,ub,ub,ub,cb,ub,ug,ux,ux,ur,ux,ux,ur
ux,ux,ux,ux,ur,ux,ux,ug,ug,ug,cb,ub,ub,ub,ub,ub,ug,ux,ux,ur,ux,ux,ur
ux,ug,ux,ux,ur,ux,ux,ug,ux,ux,ub,ub,ub,ub,ub,ub,ug,ux,ux,ur,ux,ux,ur
ux,ug,ux,ux,ur,ux,ux,ug,ux,ux,cb,ub,ub,ub,cg,ug,ug,ux,ux,ur,ux,ux,ur
ux,ug,ux,ux,ur,ux,ux,ug,ux,ux,ux,ub,ub,ub,ub,ux,ux,ux,ux,ur,ux,ux,ur
ux,ug,ux,ug,ur,ug,ux,ug,ux,ux,ux,ub,ub,ub,ub,ux,ux,ux,ux,ur,ux,ux,ur
ux,ug,ux,ug,ur,ug,ug,ug,ug,ug,ug,ug,ug,ug,ug,ug,ug,cg,ux,ur,ux,ux,ur
ux,ug,ug,ug,ur,ur,ur,ur,ug,ug,ug,ug,ur,ur,ur,ur,ur,ur,ur,ur,ur,ur,ur
ux,ux,ux,ug,ug,ug,ug,ug,ug,ug,ug,ug,ux,ux,ux,ub,ub,ux,ub,ub,ux,ux,cb
cg,ux,ux,ux,ux,ux,ux,ux,ux,ux,ux,ux,ux,ux,ux,ux,ux,ux,ub,ux,ux,ux,ub
cb,ux,ux,ux,ux,ux,ux,ux,ux,ux,ux,ux,ux,ux,ux,ux,ux,ub,ub,ux,ub,ub,ub
ux,ux,ux,ux,ux,ux,ux,ux,ux,ux,ux,ux,cg,ux,ux,ux,ub,ub,ub,ux,ub,cr,cb
cb,ux,ux,ux,ux,ux,cr,cb,cr,ux,ux,cg,cb,ux,ux,cb,ub,ub,ub,cr,cb,cr,cb