ur,ug,ug,ug,ug,ug,ur,cb,cb,cb,cb,cg,cg,cb,ug,ug,ug,ur,ur,ub,cb,cb,cb
ur,ug,ug,ug,ug,ug,ur,ug,ug,ug,ug,ug,ug,ug,ug,ur,ur,ur,ur,ub,ub,ub,cg
ur,ug,ug,ug,ug,ug,ur,ug,ug,ug,ub,ur,ub,ub,ur,ub,ug,ur,ur,ub,ur,ur,ur
ur,ug,ux,ug,ug,ug,ur,ug,ug,ug,ug,ug,ub,ur,ur,ub,ug,ur,ur,ub,ur,ub,ur
ur,ug,ug,ug,ug,ug,ug,ug,ug,ug,ug,ug,ug,ug,ug,ug,ug,ug,ur,ur,ur,ur,ur
ur,ug,ug,ug,ug,ug,ug,ug,ug,ug,ug,ug,ug,ug,ug,ug,ug,cg,ug,ug,cg,ur,ug
ur,ug,ug,ug,ug,ur,ur,ur,ug,ug,ug,ug,ug,ug,ug,ug,ug,ug,ur,ur,ub,ur,ug
ur,ug,ug,ur,ug,ug,ur,ug,ug,ug,ub,ur,ur,ur,ur,ug,ug,ur,ub,ur,ug,ur,ug
ur,ug,ug,ur,ug,ug,ur,ug,ug,ug,ug,ug,ug,ug,ug,ug,ug,ug,ur,ur,ur,ur,ur
ur,ug,ug,ur,ug,ug,ur,ug,ug,ug,ug,ug,ug,ug,ug,ug,ug,ug,ug,ur,ur,ur,ur
ur,ug,ug,ur,ur,ur,ur,ur,ug,ug,ug,ur,ur,ug,ug,ug,ug,ug,ug,ur,ur,ur,ur
ur,ur,ur,ur,ur,ur,ur,ur,ur,ur,ug,ur,ug,ug,ug,ug,ug,ug,ug,ur,ug,ur,ur
ur,ur,ug,ur,ug,ur,ur,ur,ur,ur,ug,ur,ug,ug,ur,ur,ug,ug,ur,ur,ur,ur,ur
ur,ur,ug,ur,ug,ur,ur,ug,ur,ug,ug,ur,ug,ug,ug,ug,ug,ug,ug,ug,ub,ub,ub
ur,ur,ub,ur,ug,ur,ur,ub,ur,ur,ug,ur,ug,ug,ug,ug,ug,ug,ug,ub,ub,ub,ub
ur,ur,ub,ur,ub,ur,ur,ub,ub,ub,ug,ug,ug,ug,ug,ug,ug,ub,ub,ub,ub,ub,ub
ur,ur,ur,ur,ub,cr,ur,ur,ur,ur,ub,ur,ug,ur,ub,ug,ug,ug,ug,cg,ub,ub,ub
ur,ug,ur,ur,ur,ur,ur,ub,ub,ub,ub,cg,ur,cr,ug,ug,ug,ug,ug,ub,ub,ub,cb
ur,ug,ur,ur,ur,ur,ur,ug,ug,ug,ub,ug,ug,ub,ug,ug,ub,ub,ug,ub,cb,ub,ur
cr,ug,ur,ur,ur,ur,ur,cg,ur,ug,ub,ur,ug,ug,ug,ug,ur,ur,ug,ub,ub,ur,ur
cb,ug,ur,ug,ug,ug,ug,ug,ur,ug,ur,ur,ug,ur,ug,ug,ug,ug,ug,ub,cb,ur,ur
ub,ug,ur,ug,ug,ug,ug,ur,ug,ug,ur,ur,cg,ug,ur,ur,ug,ug,ug,ub,ub,cr,cb
cb,ur,ur,ur,cr,ug,ug,ug,ug,ug,ur,cg,cb,ug,ug,ug,ug,cb,ug,cr,ub,cr,cb