ug,ug,cr,ug,ug,ug,ug,cb,cb,cb,ur,cg,cg,ur,ur,ur,ub,ur,ur,ur,cb,cb,cb
ug,ug,ug,ug,ug,ug,cr,cr,ug,ur,ur,ur,ur,ur,ur,ur,cb,ub,ub,ub,ub,ub,ub
ug,cr,cg,ug,ug,ub,ur,ur,ub,ub,ub,ub,ub,ub,ub,ub,ub,ub,ub,ub,ub,ub,ub
ug,ug,ub,ur,ur,ur,ur,ur,ur,ur,ur,ug,ur,ur,ur,ur,ur,ur,ur,ur,ur,ur,ur
ug,ug,ub,ug,ur,ug,ug,ur,ur,ur,ur,ug,ur,ur,ur,ur,ur,ur,ur,ur,ur,ur,ub
cg,ug,ub,ur,ur,ur,ug,ur,ur,ur,ur,ur,ur,ug,ug,ug,ub,ub,ub,ur,ur,ub,ub
cg,ug,ub,ug,ub,ur,ub,ur,ur,ur,ur,ur,ur,ug,ur,ug,ug,ug,ub,ur,ub,ub,ub
ub,ug,ur,ur,ur,ur,ub,ur,ur,ug,ug,ur,ur,ug,ub,ub,ub,ug,ug,ur,ur,ur,ub
ug,ug,ur,ub,cb,ub,ub,ub,ur,ug,ug,ur,ur,ug,ug,ub,ur,ug,ur,ur,ub,ur,ub
ug,ug,ur,ug,ug,ub,ub,ub,ub,ug,ug,ug,ub,ug,ub,ub,ub,ug,ug,ug,ub,ur,ub
ug,ug,ur,ug,ug,ug,ub,ub,ub,ug,ub,ug,ug,ug,ug,ub,ug,ur,ur,ug,ur,ur,ub
ug,ug,ur,ub,ub,ub,ub,ub,ub,ug,ub,ug,ub,ub,ug,ub,ub,ur,ub,ug,ub,ur,ub
ug,cr,ur,ur,ur,ub,ub,ub,ub,cg,ub,ug,ub,ub,ub,ub,ug,ur,ug,ug,ub,ub,ub
ug,ur,ub,ub,ur,ub,ub,cb,ub,ur,ub,ug,ug,ug,ug,ub,ug,ur,ub,ug,ur,ur,ub
cg,ur,ub,ug,ur,ub,ur,ur,ur,ur,ug,ug,ug,ug,ug,ub,ur,ur,ug,ug,ub,ub,ub
ub,ur,ur,ur,cg,ug,ug,ug,ur,ur,ug,ug,ug,ug,ug,ub,ug,ug,ug,ug,ub,ub,ub
ub,ug,ur,ug,ug,ur,ur,ug,ur,ur,ur,ug,ub,ur,ub,ub,ur,ub,ug,ug,ub,ub,cb
ub,ug,ur,ug,ug,ug,ug,ug,ur,ur,ur,ur,ur,ur,ub,ub,ug,ug,ug,ug,ub,ur,ub
ub,ug,ur,ub,ug,ug,ug,ug,ub,ur,ur,ug,ur,ug,ug,ub,ug,ug,ug,ub,ub,ur,ub
ub,ub,ub,ub,ug,ug,ug,ug,ub,ur,ur,ug,ur,ub,ub,ub,ub,ub,ub,ub,ub,ub,ub
cb,cb,ub,ub,ug,ug,ug,ug,ub,ur,ur,ug,ur,ur,ur,cr,ur,ur,ur,ub,ub,ur,ug
ug,ug,ug,ug,ug,ug,ug,ug,ug,ur,ur,ug,cg,ur,ur,ur,ur,ur,ur,ub,ub,cr,cb
cb,ug,ug,ug,ug,ug,cr,ug,cr,ur,ur,cg,cb,ur,ur,cb,ur,ur,ur,cr,ub,cr,cb