ux,ur,cr,ur,ur,ur,ur,cb,cb,cb,cg,cg,cg,cb,ur,ur,ur,ur,ur,ur,cb,cb,cb
ux,ur,ur,ur,ur,ur,ur,cg,ur,ur,ur,ur,ur,ur,ur,ur,ur,ur,ur,ur,ur,ur,ub
ux,cr,ur,ur,ur,ur,ur,cg,ur,ur,ur,ur,ur,cr,ur,ur,ur,ur,ur,ur,ub,ub,ub
ux,ux,ur,ux,ux,ur,ur,ug,ug,cr,ur,ur,cb,ub,cr,ur,ur,ur,ur,ub,ub,ur,ur
ux,ur,ur,ug,ug,ug,ug,ug,ug,ur,ug,ur,ur,ur,ur,ur,ur,ur,ur,ur,ur,ur,ur
ux,ur,ux,ug,ur,ur,ur,ug,ug,ur,ur,ur,cr,ur,ug,cr,ug,ur,ur,ur,ur,ur,ur
ux,ur,ux,ug,ug,ug,ur,ur,ur,ur,ur,ur,ur,ur,ur,cg,ug,ur,ur,ug,ux,ux,ux
ux,ur,ux,ur,ux,ug,ur,ur,ur,ur,ur,ur,ur,ur,ur,ur,ur,ur,ur,ux,ub,ux,ux
ux,ur,ur,ur,ur,ug,ug,ur,ur,ur,ur,ur,ur,ur,ur,ur,ub,ub,ub,ub,ub,ub,ux
ur,ur,ur,ur,ur,ur,ug,ub,ub,ur,ur,ur,cr,ux,ur,ur,ux,ub,ub,ub,ub,ub,ub
ur,ur,ur,ur,ur,ur,ug,ug,cg,ur,ur,ur,ux,ur,ug,ug,ug,ug,ub,cb,ux,ub,ub
ur,ur,ur,ur,ug,ug,ub,ug,ug,ug,ug,ur,ur,ur,ur,ur,ur,ur,ur,ur,ur,ur,ur
ur,ur,ur,ur,ug,ug,ug,ug,ug,ug,ub,ug,ub,ub,ub,ub,ug,ug,ub,ub,ux,ux,ur
ux,ur,ub,ub,ug,cg,ub,ub,ug,ug,cb,ug,ux,ur,ug,ux,ux,ux,ub,ub,ux,ux,cr
ux,ux,ub,ur,ux,ub,ub,ub,ub,ug,ug,cb,ug,ug,ug,ug,ug,ux,ub,ub,ux,ux,ux
ux,ux,ub,ux,ux,ub,ub,ub,ub,ub,ub,ub,ur,ur,ur,ur,ur,ur,ur,ub,ux,ux,ux
ux,ux,ub,ub,ub,ub,ub,ub,ub,ub,ur,ub,ub,ub,ur,ux,ux,ur,ur,ub,ux,ux,ux
cb,ub,ub,ub,ub,ub,ub,ub,ux,ur,ur,ub,ub,ub,ug,ug,ug,ur,ur,ub,ub,ub,ub
ub,ub,ub,ux,ux,ux,ux,ux,ux,ur,ur,ux,ug,ur,ur,ux,ux,ur,ur,ub,ub,ub,cb
cg,ux,ux,ux,ux,ux,ux,ux,ux,ur,ur,ux,ug,ug,ug,ug,ug,ur,ur,ub,ub,ub,ux
cb,ux,ux,ux,ux,ux,ux,ux,ux,ur,ur,ux,ux,ux,ux,ux,ux,ur,ur,ux,ux,ux,ux
ux,ux,ux,ux,ux,ux,ux,ux,ux,ur,ur,ux,cg,ux,ux,ux,cb,ur,ur,ux,ux,cr,cb
cb,ux,ux,ux,ux,ux,cr,cb,cr,ur,ur,cg,cb,ux,ux,ux,cr,ur,ur,cr,ux,cr,cb