ur,ur,cr,ug,ur,ur,ur,cb,cb,cb,cg,ur,cg,ur,ur,ur,ur,ur,ur,cb,cb,ux,cb
ur,ur,cr,cr,ur,ur,ur,ur,ur,ur,ur,ur,ur,ur,ur,ur,ur,ur,ur,ur,ur,cb,cb
ur,ur,ur,ug,cg,ur,ur,ur,cr,ur,ur,ur,ur,ur,ur,ur,ur,ur,ux,ux,ur,ux,ux
cg,ur,ur,ug,cg,ur,ur,ur,cb,ub,ub,ub,ug,ub,ur,ur,ur,ur,ub,ub,ub,ub,ub
ur,ur,ur,ur,ug,cr,ub,cr,ux,ur,ur,ub,ug,ub,ur,ur,ur,ub,ub,ub,ub,ub,ub
ur,ur,ur,ur,ur,ug,ub,ug,ub,ub,ur,ub,ub,ub,ug,ur,ur,ur,ur,ur,ur,ur,ux
ur,ur,ur,ub,ur,ur,ub,ug,cg,ub,ub,ub,ub,ub,ug,ug,ug,ug,ug,ur,ur,ur,ur
ux,ug,ug,ug,ug,ug,ur,ur,ur,ur,ur,ub,ub,ub,cb,ux,ug,ug,ug,ur,ug,ux,cr
ux,ur,ur,ur,ug,ug,ug,ub,ub,ur,ur,ub,ux,ux,ux,ux,ux,ux,ux,ur,ub,ub,ux
ux,ur,ux,ug,ur,ur,ur,ur,ur,ur,ub,ub,ub,cb,ub,ub,ux,ub,ub,ur,ub,ub,ux
ux,ur,ur,ur,ur,ur,ur,ur,ur,ur,ub,ur,ub,ub,ub,ub,ug,ug,ug,ur,ur,ub,ux
ux,ux,ux,ux,ux,ux,ur,ur,ur,ub,ub,ur,ug,ug,ub,ub,ug,ug,ug,ur,ur,ux,ux
ub,ub,ub,ub,ub,ub,ur,ub,ug,ub,ub,ug,ug,ug,ub,ug,ug,ug,ug,ur,ur,ux,ux
ub,ub,cr,ur,ur,ub,ur,ub,cg,ub,ub,ug,ug,ug,ug,ug,ug,ug,ug,ur,ur,ux,ux
ub,ub,ub,ub,cb,ux,ub,ub,ug,ub,ub,ux,ug,ug,ug,ug,ug,ug,ug,ur,ur,ux,ux
ub,ub,ub,ub,ub,ur,ur,ux,ug,ub,ug,ub,ug,ug,ug,cg,ug,ug,ug,ur,ur,ux,ux
ub,ub,ub,ub,ub,ux,ux,ux,ug,ug,ug,ug,ug,ug,ug,ux,ur,ub,ur,ur,ur,ux,ux
ub,ub,ux,ur,ur,ux,ux,ux,ux,ux,ub,ub,ub,ub,ux,ux,ub,ub,ux,ur,ux,ux,ux
ux,ux,ux,ur,ur,ux,ux,ux,ux,ux,ux,ub,ub,ub,ux,ux,ub,ub,ux,ur,ur,ur,cb
cg,ux,ux,ur,ur,ux,ux,ux,ux,ux,ux,ur,ur,ub,ub,ub,ur,ur,ur,ur,ur,ur,ur
cb,ux,ux,ur,ur,ur,ur,ur,ur,ur,ur,ur,ur,ub,ur,ub,ur,ur,ur,ur,ur,ur,ur
ur,ur,ur,ur,ur,ur,ur,ur,ur,ur,ur,ur,cg,ux,ub,cb,ub,ur,ur,ur,ur,cr,ur
ur,ur,ur,ur,ur,ur,cr,ux,cr,ux,ux,cg,cb,ux,ux,ub,cr,ux,ux,cr,ur,cr,cb