ur,ur,cr,ur,ur,ur,ur,cb,cb,cb,cg,ux,cg,ux,ux,ux,cb,ux,ux,cb,cb,ux,cb
ur,ur,ur,cr,ur,ur,ur,ur,ur,ur,ur,ux,ub,ub,ub,ub,ub,ub,ub,ub,ub,ub,cb
ur,cb,ub,ub,ur,cr,ur,ur,ur,ur,ur,ur,ub,ux,ux,ux,ux,ub,ux,ux,ux,ux,ux
cg,ug,cg,ur,cr,ur,ur,ur,ur,ur,ur,ur,ub,ur,ur,ux,ux,ub,ux,ux,ux,ux,ux
ur,ur,ur,ur,ur,ur,ur,ur,ur,ur,ur,ur,ub,ur,ur,ux,ux,ub,ux,ux,ux,ux,ux
ur,ur,ur,ur,ur,cr,ur,ur,ur,ur,ur,ur,ub,ub,ur,cr,ub,ub,ux,ux,ux,ux,ux
ur,ur,ur,ug,ug,ug,ug,ug,ug,ug,ug,ur,ub,ub,ur,ub,ub,ur,ub,ub,ub,ub,ub
ur,ur,ur,ug,ug,ug,ug,ug,ur,ur,ug,ug,ub,ux,cb,ux,ub,ub,ub,ub,ub,ub,ub
ur,ur,cg,cr,ux,ux,ux,ub,ug,ux,ub,ug,ub,ux,ub,ux,ux,ur,ub,ub,ub,ub,ub
ur,ur,ur,ur,ux,ux,ux,ub,ug,ux,ub,ug,ux,ux,ub,ug,ug,ug,ug,ux,ub,ub,ux
ug,ux,ux,ur,ux,ux,ux,ub,ug,ub,ub,ug,ug,ug,ub,ug,ug,ug,ub,ub,ub,ub,ub
ug,ux,ux,ur,ux,ux,ux,ub,ub,ub,ub,ub,ug,ug,cg,ug,ux,ub,ub,ub,ub,ub,ub
ug,ux,ux,ur,ub,ub,ug,ub,ub,ub,ub,ub,ug,ug,ug,ug,ug,ug,ur,cb,ub,ub,ub
ug,ux,ux,ur,ux,ub,ub,ub,ub,ub,ug,ub,ug,ug,ug,ug,ug,ug,ur,ub,ub,ub,cg
ug,ux,ux,ur,ub,ub,ub,ub,ub,ub,ub,ub,ug,ub,ub,ub,ur,ur,ur,ub,ur,ur,ur
ug,ux,ux,ur,ux,ub,ub,ub,ub,ub,ub,cb,ub,ub,ub,ub,ux,ux,ur,ux,ur,ub,ur
ug,ux,ux,ur,ux,ub,ub,ub,ub,ub,ub,ub,ub,ub,ub,ub,ux,ux,ur,ux,ur,ux,ur
ug,ug,ug,ur,ux,cr,ub,ub,ub,ub,ub,ub,ub,ub,ub,ub,ux,ux,ur,ux,ur,ur,ur
ux,ux,ug,ur,ur,ur,ub,ub,ub,ub,ub,ub,ub,ub,ub,ub,ux,ux,ur,ux,ux,ur,ur
cg,ux,ug,ux,ub,ur,ub,cb,ur,ur,ur,ur,ur,ur,ub,ub,ur,ur,ur,ur,ur,ur,ur
cb,ux,cg,ux,ux,ur,ub,ux,ux,ux,ux,ub,ub,ub,ub,ub,ur,ur,ur,ur,ur,ur,ur
ur,ur,ur,ur,ur,ur,ub,ub,ub,ub,ub,ub,cg,ux,ux,ux,ux,ux,ux,ux,ux,cr,ur
ur,ur,ur,ux,ux,ux,cr,ux,cr,ux,ux,cg,cb,ux,ux,ux,cr,ux,ux,cr,ux,cr,cb