ug,cr,cr,ug,ug,ug,ur,cb,cb,cb,ub,cg,cg,ur,ur,ur,ur,ur,ur,ur,cb,cb,cb
ur,ur,ur,ur,ur,ur,ur,ur,ur,ur,ur,ur,ub,cg,ug,ug,ug,ug,ug,ur,ub,ub,ug
ug,ug,ur,ub,ub,ub,ub,ub,ub,ub,ub,ur,ur,cr,ub,ub,ub,ub,ug,ur,ub,ub,ug
ug,cb,ub,ub,ub,ub,ur,ub,ub,ub,ub,ub,ub,ur,ub,ub,ub,ub,ug,ur,ub,ub,ug
ub,ub,ub,ub,ub,ug,ug,ug,ug,ug,ug,ug,ug,ur,ug,ug,ug,ug,ug,ur,ug,ur,ug
ub,ub,ub,ub,ug,ug,ug,ug,ub,ug,ub,ub,ub,ur,ub,ub,ub,ub,ub,ur,ub,ur,ug
cg,ub,ur,ub,ug,ug,ur,ub,ub,ub,ub,ub,ub,ur,ub,ug,ug,ur,ur,ur,ub,ur,ug
ub,ug,ur,ur,ug,ug,ur,ub,ub,ub,ub,ub,ub,ur,ug,ug,ug,ur,ur,ur,ur,ur,ug
ug,ug,ug,ug,ug,cb,ur,ub,ug,ub,ug,ug,ug,ur,ur,cr,ub,ub,ub,ur,ub,ub,ug
ug,ug,ur,ug,ug,ub,ub,ub,cr,ub,ug,cb,ub,ug,ug,cg,ub,ub,ub,ur,ub,ub,ug
ug,ug,ur,ug,ug,ub,ub,ub,ur,ur,ub,ub,ub,ub,ub,ub,ub,ub,ub,ub,ub,ub,ug
ug,ug,ug,ug,ug,ub,ub,ub,ub,ur,ub,ub,ub,ub,ug,ub,ug,ug,ug,ug,ub,ur,ug
ug,ug,ur,ug,ug,ur,ub,ub,ub,ur,ub,ub,ub,ub,ug,cb,ub,ug,ub,ur,ub,ur,ug
ug,ug,ug,ug,ug,ur,ub,ub,cb,ub,ub,ub,ub,ub,ur,ug,ug,ub,ub,ub,ub,ur,cg
ug,ug,ug,ug,ug,ur,ur,ur,ur,ub,ub,ug,ug,ug,ug,ug,ub,ub,ug,ug,ug,ug,cg
ug,cg,ur,ur,ur,ur,ug,ub,ub,ug,ur,ur,ur,ub,ub,ub,ub,ub,ub,ub,ug,ur,ur
ug,ug,ur,ug,ur,ur,ur,ur,ub,ur,ub,ub,ub,ub,ub,ur,ur,ub,ur,ug,ug,ur,ur
ug,ug,ur,ug,ug,ug,ur,ur,ub,ub,ub,ub,ub,ub,ug,ur,ur,ur,ur,ur,ug,ur,ur
ug,ug,ur,ug,ug,ug,ur,ub,cb,ub,ub,ub,ub,ub,ub,ur,ug,ug,ug,ug,ug,ur,ur
ug,ug,ur,ur,ur,ur,ur,ub,ub,ub,ub,ub,ub,ur,ur,ur,ur,ug,ug,ug,ug,ur,ur
cb,ug,ug,ug,ug,ug,ug,ug,ug,ug,ug,ub,ub,ub,ub,ub,ug,ug,ug,ug,ub,ur,ur
ug,ug,ug,ug,ug,ug,ug,ug,ug,ug,ug,ub,cg,ub,ub,ug,ug,ug,ug,ug,ub,cr,cb
cb,ug,ug,ug,ug,ug,cr,ug,ug,ug,ur,cg,cb,ub,ub,ub,ub,ub,ug,cr,cb,cr,cb