cr,ur,cr,cb,ub,ub,cr,cb,cb,cb,cg,cg,cg,ur,ur,ur,ur,ur,ur,ux,cb,cb,cb
cg,ur,ur,ur,ur,ur,ur,ux,ur,ur,ur,ur,ur,ur,ur,cr,ux,ux,ur,ur,ur,ur,ur
ur,cr,ur,ur,ux,ur,ur,ux,ux,ux,ur,ur,ur,ur,ur,ur,ur,ur,ur,ur,ur,ur,ur
ur,ur,ur,ur,ur,ur,ur,ur,ur,ur,ur,ur,ub,ur,ur,ur,ur,ur,ur,ur,ur,ur,ur
ur,ur,ur,ur,ur,ur,ur,ur,ur,ur,ur,ux,ub,ur,ur,ur,ub,ub,ub,ub,ub,ub,ur
ux,ux,ux,ux,ux,ur,ur,ur,ur,ur,ur,ux,ub,ux,ux,cr,ub,ux,ux,ux,ux,ub,ux
ux,ux,ux,ux,ux,ux,ux,cr,ur,ur,ur,ux,ub,ux,ux,ur,cb,ux,ux,ux,ux,ub,ux
ux,ux,ux,ux,ux,ux,ux,ub,ux,cr,ux,ux,ub,ux,ux,ux,ux,ux,ux,ux,ux,ub,ux
ur,ur,ur,ur,ux,cb,ub,ub,ub,ub,ub,ux,ub,ub,ub,cg,ug,ug,ug,ug,ub,ub,ux
ur,ux,ux,ug,ug,ug,ug,ug,ux,ux,ux,ux,ux,ub,ub,ug,ug,ub,ub,ub,ub,ux,ux
ur,ux,ux,ug,ux,ux,ub,ug,ub,ub,ux,ux,ux,ub,ub,ug,ug,ug,ug,ug,ub,ux,ux
ur,ux,ux,ug,ux,ux,ux,cg,ux,ub,ub,ub,ub,ub,ug,cg,ug,ug,ux,ug,ub,ug,ux
ur,ux,ux,ug,ux,ux,cb,ub,ub,ub,ub,ub,ub,ub,ug,ug,ug,ug,ug,ug,ux,ug,ux
ur,ux,ux,ug,ux,ux,ux,ux,ux,ux,cb,ux,ux,ug,ug,ub,ux,ux,ux,ux,ug,ug,ux
ur,ux,ux,ug,ux,ug,ux,ux,ux,ux,ub,cb,ug,ug,ug,ug,ug,ux,ug,ug,ux,ux,ux
ur,ux,ug,ug,ux,ug,ux,ux,ux,ux,ub,ug,ux,ug,ux,ub,ug,ug,ug,ug,ux,ux,ux
ur,ug,ug,ug,ug,ug,ux,ux,ux,ub,ub,ug,ug,ug,ux,ub,ux,ug,ug,ug,ux,ux,ux
ur,cr,ug,ug,ug,ug,ux,ux,ux,ub,ug,ug,ux,ux,ux,ub,ux,ug,ug,ug,ux,ux,ux
ux,ux,ux,ur,ug,ug,ux,ux,ux,ub,ug,ug,ux,ux,ux,ux,ux,ux,ux,ug,ux,ux,cb
cg,ux,ux,ur,ug,ug,ux,ub,cr,ur,ur,ur,ur,ur,ur,ur,ur,ur,cg,ug,ur,ur,ur
cb,ux,ur,ur,ux,ux,ux,ub,ub,ub,ub,ub,ur,ur,ur,ur,ur,ur,ur,ur,ur,ur,ur
ux,ux,ur,ux,ux,ub,ub,ub,ub,ub,ub,ux,cg,ux,ux,ux,ux,ux,ux,ux,ux,cr,cb
cb,ux,ur,ur,ur,ux,cr,cb,cr,ub,ub,cg,cb,ux,ux,ux,ux,ux,ux,cr,ux,cr,cb