cb,cr,ur,ub,ub,cb,cb,ub,ug,ub,ub,ug,ux,ux,ur,ub,ur,ur,ur,ub,ub,cb,cr
cr,ur,ux,ur,ub,ug,ub,ux,ub,ub,ub,ub,ub,ub,ub,ub,ux,ux,ux,ub,ub,ub,cb
ur,cr,ux,ux,ux,ux,ub,ub,ub,ug,ug,ug,ux,ub,ux,ub,ub,ub,ub,ub,ub,ub,cb
ur,ur,ux,ux,ux,ux,cg,ux,ux,ug,ug,ub,ub,ub,ux,ux,ux,ux,ux,ux,ur,ur,cr
ur,ux,ux,ug,ux,ux,ug,ub,ub,ug,ug,ub,ub,ux,ux,ux,ux,ux,ux,ux,ub,ub,cb
ur,ux,ug,ug,ux,ux,ug,ug,ug,ug,ug,ux,ux,ux,ux,ux,ux,ux,ux,ux,ub,ub,ur
ur,ur,ug,ux,ux,ug,ug,ub,ux,ug,ux,ux,ux,ux,ux,ux,ux,ux,ux,ux,ub,ub,ub
ur,ur,ug,ug,ug,ug,ub,ug,ug,ug,ub,ub,ub,ub,ub,ux,ux,ux,ux,ub,ub,ub,ub
ub,ub,ub,ub,ub,ug,ug,ug,ub,ug,cb,ug,ug,cg,ub,ux,ux,ux,ux,ux,ux,ub,ub
ug,ub,ub,ux,ux,ux,ub,ub,ub,ug,ub,ug,ux,ub,ub,ux,ux,ux,ux,ub,ub,ub,ub
ug,ub,ub,ux,ux,ux,ub,ub,ub,ub,ub,ug,ug,ub,ub,ux,ux,ux,ux,ux,ux,ub,ub
cg,ub,ug,ug,ug,ug,ug,ub,ub,ub,ub,ug,ug,ub,ub,ux,ux,ux,ux,ux,ux,ux,ub
cb,ub,ub,ug,ug,ur,ur,ux,ux,ub,ub,ub,ub,ub,ub,ub,ub,ux,ux,ux,ux,cb,ub
cb,ux,ux,ug,ux,ux,ur,ux,ux,ub,ub,ub,ug,ug,ux,ug,ub,ug,ux,ux,ux,ux,ur
cr,ur,ux,ug,ux,ux,ur,ux,ux,ux,ux,ux,ux,ux,ux,ug,ub,ub,ux,ux,ux,ux,cr
ur,ur,ur,ug,ux,ux,ur,ux,ug,ug,ug,ug,ug,ug,ug,ug,ug,ub,ub,ux,ux,ub,ub
ur,ur,ux,ug,ux,ux,ur,ux,ux,ub,ub,ub,ub,ub,ux,ux,ux,ux,ub,ub,ub,ug,ug
ur,ur,ux,ug,ux,ux,ub,ub,ub,ub,ux,ux,ux,ub,ux,ux,ux,ub,ub,ux,ux,ug,ug
ur,ub,ux,ug,ug,ux,ub,ux,ux,ux,ux,ux,ux,ub,ux,ux,ux,ux,ub,ux,ub,ug,ug
cr,ub,ur,ux,ug,ux,ub,ux,ux,ux,ux,ux,ub,ub,ux,ux,ux,ux,ub,ub,ub,ug,cg
cg,ub,ub,cb,ub,ub,ub,ux,ub,ub,ub,ux,ub,ub,ub,ub,ub,ub,ub,ub,ur,ur,cr
cr,cb,ub,ug,ur,ur,ur,ub,ub,ub,ub,ub,ub,ub,ub,ub,ub,ux,ux,ur,ur,ug,cg
cg,cg,cb,cg,cr,ur,cr,cb,cr,ub,cb,ub,ub,ug,ug,ug,ug,cg,ub,ur,ur,cr,cg