ur,ur,cr,ur,ur,ur,ur,cb,cb,cb,cg,ur,cg,ur,ur,cb,ur,ur,ur,cb,cb,ur,cb
ux,ur,ur,ug,ug,ug,cr,ur,cg,ug,ug,ug,ub,ub,ur,ur,ur,ur,ur,ur,ur,ur,cb
ux,ur,ur,ug,cg,ur,ur,ur,ur,ur,cr,ug,ur,ub,ur,ur,ur,ur,ur,ur,ur,ur,ux
cg,ur,ur,ug,ug,ub,ub,ur,ur,ur,ug,ub,ur,ub,ur,ur,ur,ur,ur,ur,ur,ur,ur
ur,ur,ur,cg,ug,ug,cb,ub,ub,ug,ub,ur,ur,ub,ur,ur,ub,cr,ux,ur,ux,ux,ur
ur,ur,ur,ur,ug,ug,ub,ur,ug,ug,ug,ur,ur,cb,ur,ur,ur,ur,ur,ur,ur,ur,ur
ur,ur,ur,ur,cr,ug,ub,ur,ur,ur,ur,ur,ub,ug,ub,ux,ux,ur,ur,ur,cr,ux,ub
ux,ur,ur,ug,ug,ug,ub,ub,ub,ux,ux,ux,ur,ur,ur,ur,ur,ur,ux,ux,ux,ux,ub
ur,ur,ur,ub,ur,ub,ux,cb,ub,ux,ux,ux,ur,ug,ug,ug,ug,ug,ug,ug,ux,ux,ub
ur,ur,ur,ub,ux,ub,ub,ub,ub,ur,ur,ur,ur,ug,ug,ux,ux,ux,ux,ug,ux,ux,ub
ux,ux,ux,ur,ur,cr,ub,ub,ub,ub,ux,ux,ux,ug,ug,ux,ug,ug,ug,ug,ux,ux,ub
ur,ur,ur,ur,ub,ub,ug,ug,ug,ug,ug,ug,ug,ug,ub,ub,ub,ub,ug,ug,ux,ux,ub
ur,ux,ux,ub,ur,ux,ug,ug,ug,ug,ug,ug,ug,ug,ub,ug,ug,ub,ub,ub,ub,ub,ub
ur,ux,ux,ux,ur,ux,ug,ug,ug,ug,ug,ug,ug,ug,ub,ub,ub,ub,ub,ub,ux,ux,cg
ur,ux,ux,ux,ur,ux,cg,ug,ug,ug,ub,ug,ug,ux,ur,ux,ub,ub,ub,ub,ub,ux,ux
ur,ur,ur,ur,ur,ur,ur,ux,ux,ub,ub,ug,ux,ux,ur,ux,ub,ub,ub,ub,ub,ub,ub
ug,ux,ux,ux,ur,ur,ur,ux,ux,ub,ub,ug,ux,ug,ug,ux,ub,ub,ub,cb,ub,ub,ub
ug,ug,ug,ux,ub,ub,ub,ub,ub,ub,ub,ub,ub,ub,ub,ub,ub,ur,ur,ur,ur,ur,ur
ux,ux,ug,ux,ub,ug,ux,ub,ug,ug,ug,ug,ug,ug,ug,ux,ux,ub,ub,ub,ub,ub,ur
cg,cb,ug,ux,ub,ug,ux,ub,ub,ub,ug,ug,ur,ug,ug,ux,ux,ub,ub,ub,ub,ub,ur
cb,ub,cr,ur,ur,ur,ur,ur,ur,ur,ur,ur,ur,ur,ur,ur,ur,ur,ur,ur,ur,ur,ur
ub,ub,ug,ug,ub,ug,ux,ux,ux,ux,ux,ux,cg,ub,ub,ub,ub,ux,ux,ux,ux,cr,ur
ub,ub,ub,ub,ub,ux,cr,ux,cr,ux,ux,cg,cb,ub,ub,ub,cr,ux,ux,cr,ux,cr,cb