ur,ur,cr,ub,ub,ur,ur,cb,cb,cb,cg,ur,cg,ur,cr,ur,cr,ur,ux,cb,cb,ur,cb
ur,ur,ur,ur,ub,cb,ub,ur,ur,ur,ur,ur,ur,ur,ur,ur,ub,ur,ub,ub,ur,ur,ur
ur,ur,ur,ur,ug,ug,ur,ur,cg,ur,ur,ur,ur,ur,ur,ur,ub,cb,ub,ub,ur,ur,ur
ur,ur,cg,ug,ug,ug,ur,ur,ug,ur,ur,ur,ur,ur,ur,ur,ub,ub,ux,ub,ub,ub,ub
ur,ur,ur,ug,cg,ug,ug,cr,ug,cr,ub,ub,ur,ur,ub,ub,ub,ub,ux,ub,ub,ub,ub
ur,ur,ur,ur,ur,ur,ur,ur,ub,ug,ug,ug,ug,ub,ub,ub,ub,ub,ux,ub,ub,ur,ub
ur,ur,ur,ur,ur,ur,cr,ub,ub,ug,ub,ub,ug,ur,ub,ur,ub,ub,ub,ub,ub,ub,ub
ug,ug,ux,ug,ur,ur,ur,ur,ur,cr,ur,ub,ug,ub,ub,ux,ub,ub,cb,ux,ur,ub,ub
ux,ur,ur,ur,ur,ub,ub,ub,ub,ug,ug,ug,ub,ub,ub,ub,ub,ub,ub,ub,ur,ub,ub
ux,ur,ug,ur,ur,ub,ux,ux,ub,ug,ug,ug,ub,ug,ub,ub,ug,ug,ug,ub,cb,ub,ub
ux,ur,ux,ur,ur,ub,ux,ux,ux,ux,ux,ug,ub,ug,ug,ub,ub,ug,ug,ug,ur,ub,ub
cg,ur,ux,ur,ur,ur,ur,ur,ur,ur,ur,ur,ub,ur,ur,ur,ur,ur,cb,ub,ur,ub,ub
ux,ur,ux,ur,ux,ub,ux,ux,ux,ub,ux,ux,ub,ub,cg,ug,ug,ug,ug,ub,ug,ur,ur
ux,ur,ux,ur,ux,ub,ub,ub,ub,ub,ub,ub,cb,ub,ug,ug,ug,ug,ug,ub,ub,ub,ur
ux,ur,ux,ur,ur,ur,ur,ur,ur,ub,ub,ub,ub,ur,ug,ug,ug,ug,ug,ub,ub,ub,ur
ux,ur,ur,ur,ur,ur,ur,ur,ub,ub,ub,ub,ub,ur,ur,ub,ub,ug,ug,ub,ub,ur,ur
ux,ux,ux,ux,ux,ux,ux,ux,ub,ub,ux,ux,ux,ur,ux,ur,ux,ux,ux,ux,ux,ur,ur
ux,ux,ux,ux,ux,ux,ux,ux,ug,ug,ux,ux,ux,ur,ux,ur,ux,ux,ux,ux,ub,ur,ur
ux,ux,ux,ux,ux,ux,ux,ux,ug,ug,ux,ux,ux,ur,ub,ur,ub,ub,ub,ub,ub,ur,cb
cg,ux,ux,ux,ux,ux,ux,ux,ux,ux,ux,ux,ux,ur,ux,ur,ur,ur,ur,ur,cr,ur,ur
cb,ux,ux,ux,ux,ux,ux,ux,ux,ux,ux,ux,ux,ur,ux,ur,ur,ux,ux,ux,ur,ur,ur
ux,ux,ux,ux,ux,ux,ux,ux,ux,ux,ux,ux,cg,ur,ux,ur,ur,ur,ur,ur,ur,cr,ur
ux,ux,ux,ux,ux,ux,cr,ux,cr,ux,cb,cg,cb,ur,ur,ur,cr,ux,ux,cr,ur,cr,cb