ur,ur,cr,ur,ur,ur,ur,cb,cb,cb,cg,ux,cg,ux,ux,ur,ur,ur,ur,cb,cb,ur,cb
ur,ur,ur,cb,ub,ub,ub,ur,ur,ux,ux,ur,ur,ur,ur,ur,ur,ur,ur,ur,ur,ur,ur
ur,ur,ur,cg,ug,ur,ub,ur,ur,ux,ur,ur,ur,ur,ur,ur,ur,ur,ur,ur,ur,ur,ur
cg,ur,ur,cr,cr,cg,ug,ub,ur,ur,ur,ur,ur,ur,ur,ur,ur,ur,ur,cb,ur,ur,ux
ur,ur,ur,ur,ur,ug,ug,ur,ur,ur,ur,ur,ur,ur,ur,ub,ub,ux,ux,ub,ux,ur,ux
ur,ur,ur,ur,ur,cg,ug,ub,ur,ur,ur,ur,ur,ux,ux,ux,ux,ub,ub,ub,ur,ur,ux
ur,ur,ur,cr,ur,ub,ug,ug,ug,ug,ug,ug,ug,ug,ug,ux,ux,ub,ur,ux,ux,ux,ux
ur,ur,ur,cr,ub,ub,ub,ub,ub,ub,ux,ub,ur,ur,ug,ur,ub,ub,ub,ub,ub,ub,ux
ur,ur,ub,ub,ub,ub,ub,ub,ub,ub,ux,ub,ux,ux,ug,ug,ug,ub,ub,ub,ub,ub,ux
cr,cb,ub,ux,ux,ub,ux,ub,ub,ub,ux,ub,ux,ux,ug,ug,ug,ug,ug,ug,ug,ub,ub
ub,ub,ub,ub,ux,ub,ux,ub,ub,ub,ub,ub,ub,ux,ug,ug,ug,ug,ug,ub,ug,ub,ub
cg,ur,ur,ur,ur,ub,ub,ub,ub,ub,ub,cb,ur,ug,ug,ug,ug,cg,ug,ug,ug,ur,ur
ub,ur,ub,ub,ub,ug,ug,ug,ub,ub,ug,ug,ub,ug,ub,ux,ux,ug,ug,ug,ux,ux,ur
ub,ur,ug,ug,ug,ug,ug,ug,ub,cb,ub,ub,ub,ug,ub,ug,ug,ug,ug,ug,ux,ux,ur
ub,ur,ug,ug,ub,ub,ux,ug,ub,ub,ub,ub,ub,ug,ub,ug,ur,ur,ur,ur,ur,ur,ur
ub,ur,ur,ur,ur,ur,cr,ug,ub,ub,ub,ub,ub,ug,ub,ug,ur,ur,ur,ur,ur,ur,ur
ub,ub,ub,ub,ub,ub,ub,ub,ub,ub,ub,ub,ug,ug,ug,ug,ux,ux,ux,ux,ux,ur,ux
ub,ub,ub,cb,ur,ur,ur,ur,cr,ug,ub,ub,ug,ug,ur,ux,ux,ux,ux,ux,ux,ur,ux
cb,ux,ux,ux,ux,ux,ux,ux,ux,ur,ub,ub,ux,ug,ur,ur,ur,ur,ur,ur,ur,ur,cb
cg,ux,ux,ux,ux,ux,ux,ux,ux,ur,ub,ub,ux,ux,ux,ux,ux,ux,ux,ux,ux,ux,ux
cb,ux,ux,ux,ux,ux,ux,ux,ux,ur,ur,ux,ux,ux,ux,ux,ux,ux,ux,ux,ux,ux,ux
ux,ux,ux,ux,ux,ux,ux,ux,ux,ur,ur,ux,cg,ux,ux,ux,ux,ux,ux,ux,ux,cr,ux
ux,ux,ux,ux,ux,ux,cr,ux,cr,ur,ur,cg,cb,ux,ux,ux,cr,ux,ux,cr,ux,cr,cb