cr,ux,cr,ub,ub,cb,ub,cb,cb,cb,cg,cg,cg,ur,ur,ux,cr,ur,ur,ur,cb,cb,cb
ux,ux,ux,ux,ux,ux,ux,ux,ux,ux,ur,ur,ub,ub,ub,ub,ur,ur,ur,ur,ur,ur,ur
ux,cr,ug,ug,ug,ug,ug,ug,ug,ug,ug,ug,ug,cg,ur,ub,ub,ub,ur,ur,ur,ur,ur
ux,ux,ug,ux,ux,ux,ux,ux,ux,cr,ur,ur,ur,ub,ub,cb,ub,cb,ur,ur,ur,ur,ur
ur,ur,ug,ur,cg,ug,ug,ug,ur,ur,ur,ur,ur,cr,ur,ur,ur,ur,ur,ur,ur,ur,ur
ur,ur,ug,ur,ur,cr,ug,ug,ux,ur,ur,ur,ur,ub,ub,ub,ub,ub,cr,ur,ur,ur,ur
ux,ux,ug,ur,ur,ur,ur,ur,ur,ur,ur,ur,ur,ur,ur,ur,ur,ux,ux,ux,ux,ux,ux
ux,ux,ug,ur,ur,ur,ur,ur,ur,ur,ur,ur,ur,ur,ux,ug,ug,ug,ug,ug,ux,ux,ux
ux,ux,ug,ux,ux,ux,ux,ux,ux,ux,ur,ur,ux,ux,ux,ux,ux,ux,ug,ug,ux,ux,ux
ux,ux,ug,ux,ux,ug,ug,ug,ux,ux,ub,ub,ub,ub,ux,ux,ux,ux,ug,ux,ux,ux,ux
ux,ux,ug,ux,ux,ug,ug,ug,ux,ub,ub,ub,ub,ub,ux,ux,ux,ux,ug,ux,ux,ux,ux
ur,ur,ur,ur,cg,ur,ur,ur,ur,ur,ub,ub,ub,ub,ub,ux,ux,ux,ux,ux,ux,ux,ux
cr,ux,ug,ug,ug,ug,ug,ur,ur,ur,ub,ub,ub,ub,ub,ug,ux,ux,ux,ux,ux,ux,ux
ux,ux,ug,ug,ug,ug,ug,ug,ub,ub,cb,ur,cb,ub,ub,ub,ub,ux,ux,ux,ux,ux,ux
ux,ux,ug,ug,ug,ur,ug,ug,ug,ug,ug,ug,ux,ur,ux,ub,ub,ux,ux,ux,ux,ux,ux
ux,ux,ux,ux,ug,cr,ur,ur,ur,ur,ur,ur,ug,cg,ug,ug,ub,ug,ug,ux,ux,ux,ux
ux,ux,ux,ux,ub,ug,ub,cg,ub,ub,ug,ug,ug,ug,ux,ug,ub,ub,ug,ug,ux,ux,ux
ux,ux,ux,ux,ug,ug,ug,ug,ub,ub,ug,ug,ux,ug,ux,ug,ux,ub,ux,ux,ux,ux,ux
ux,ux,ux,ux,ux,ur,ub,ub,ub,ub,cb,ux,ux,ux,ux,ug,ux,ub,ux,ux,ux,ux,cb
cg,ux,ux,ux,ux,ur,ux,ux,ux,ux,ux,ux,ux,ux,ux,ux,ux,cb,ux,ux,ux,ux,ux
cb,ux,ux,ux,ux,ur,ux,ux,ux,ux,ux,ux,ux,ux,ux,ux,ux,ux,ux,ux,ux,ux,ux
ux,ux,ux,ux,ux,ur,ux,ux,ux,ux,ux,ux,cg,ux,ux,ux,ux,ux,ux,ux,ux,cr,cb
cb,ux,ux,ux,ux,ur,cr,cb,cr,ux,ux,cg,cb,ux,ux,ux,ux,ux,ux,cr,ux,cr,cb