ur,ur,cr,ur,ur,ur,ur,cb,cb,cb,cg,ur,cg,ur,ur,ur,ur,ur,ur,ur,cb,ur,cb
ur,ur,ur,ur,ur,ur,ur,ur,ur,ur,ur,ur,ur,ur,ur,ur,ur,ur,ur,ug,ug,ug,ug
ur,ur,ug,ug,cg,ur,ur,ur,ur,ur,ur,ur,ur,ur,ur,ur,ur,ub,ub,ub,ub,ur,ug
cb,cg,ug,cr,ur,ur,ur,ur,ub,ub,ub,ub,ur,ur,ur,ur,ur,ub,ub,ub,ub,ug,ug
ur,ug,ug,ug,ug,cr,ur,ur,ub,ub,ug,ur,ur,ur,ur,ub,ub,ub,ug,ug,ug,ug,ug
ur,ur,ug,ug,ur,ur,ur,ur,ur,ub,ug,cr,ur,ur,ur,ur,ug,ur,ur,ur,ur,ur,ug
ur,cr,ur,ur,ur,ur,ur,ub,ur,ub,ug,cr,ur,ur,ur,ug,ug,ur,ug,ug,ub,ub,ub
ub,ur,ur,ur,ur,ur,ub,ub,ur,ub,cg,cb,ug,ug,ub,ug,ug,ur,ug,ug,ub,ub,ub
ub,ur,ur,ux,ux,ux,ux,ux,ur,ub,ub,ug,ug,ug,ug,ug,ug,ur,ug,ux,ub,ub,ub
ub,ur,ur,ux,ux,ux,ux,ux,ur,ub,ub,ux,ub,ug,ug,ug,ug,ur,ug,ux,ub,ub,ub
ub,ub,ub,ux,ux,ux,ux,ux,ur,ug,ub,ux,ub,ug,ug,ug,ug,ug,ux,ux,ub,ub,ub
ub,cb,ub,ux,ux,ux,ux,ux,ur,ug,ug,ux,ub,ug,ug,ug,ug,ug,ux,ux,ub,ub,ub
ur,ur,ub,ub,ub,ug,ug,ug,ug,ug,ug,ub,ub,ux,ux,ug,ug,ug,ux,ux,ub,ub,ub
ur,ur,ur,ux,ub,ug,ux,ug,ug,ug,ug,ub,ub,ug,ug,ug,cr,ur,ur,ur,cb,ub,ub
ur,ur,ur,ux,ux,ug,ug,ug,ug,ug,ub,ub,ub,ug,ug,ug,ux,ug,ux,ux,ug,ub,ur
ur,ur,ur,ur,ur,ur,cg,ug,ur,ub,ub,ur,ub,ub,ub,ug,ug,ug,ux,ux,ug,ub,ur
ur,ur,ur,ur,ur,ub,ub,cb,ur,ub,ux,ux,ux,ux,ub,ub,ux,ux,ux,ux,ug,ub,ur
ur,ur,ur,ur,ur,ub,ur,ur,ur,ur,ur,ur,ur,ur,ur,cb,ub,ug,ug,ug,ug,ur,ur
ub,ub,ur,ub,ub,ub,ub,ub,ub,ur,ur,ur,ur,ur,ur,ub,ub,ug,ub,ur,ur,ub,cb
cg,ub,ub,ub,ub,ub,ub,ub,ub,ux,ux,ux,ux,ux,ux,ux,cg,ug,ub,ur,ur,ur,ur
cb,ub,ub,ub,ub,ub,ub,ub,ub,ur,ur,ur,ur,ur,ur,ur,ur,cr,ur,ur,ur,ur,ur
ux,ub,ub,ub,ux,ub,ub,ub,ub,ub,ux,ux,cg,ux,ux,ux,ur,ur,ur,ur,ux,cr,cb
ub,ur,ur,ur,ur,ur,cr,ub,cr,ux,ux,cg,cb,ux,ux,ux,cr,ux,ux,cr,ux,cr,cb