ur,ur,cr,ub,ub,ub,cb,cb,cb,cb,ur,cg,cg,ur,ur,ur,ur,ur,ur,ur,cb,cb,cb
ur,ur,ur,ur,ur,ur,ur,ur,ur,ur,ur,ur,ur,ur,ur,ur,ur,ur,ur,ug,ug,ug,ur
ur,cr,cb,ur,ur,ub,cb,cr,ur,ug,ur,ur,ur,ur,ur,ur,ur,ur,ur,ur,ur,ug,ur
ur,cb,ur,ur,ur,ur,ub,ur,ur,ug,ur,ur,ur,ur,ur,ur,ur,ur,ur,ur,ur,ug,ug
ur,ub,ur,ur,ur,ur,ur,ur,ur,ug,ur,ur,ur,ur,ur,ur,ur,ur,ur,ur,ur,ug,ug
cg,ub,ub,ub,ur,ur,ur,ur,ur,ug,ur,ur,ur,ur,ur,ur,ur,ur,ur,ur,ur,ug,ug
cg,ub,ub,ur,ur,ur,ur,ur,ur,ug,ur,ur,ur,ur,ur,ur,ur,ur,ur,ur,ug,ug,ug
ur,cg,ub,cr,ur,ur,ur,ur,ur,ug,ur,ur,ur,ur,ur,ur,ur,ur,ur,ur,ug,ug,ug
cr,ug,cb,ub,ub,ub,ur,ur,cg,ug,ur,ur,ur,ur,ur,ug,ur,ur,ur,ur,ug,ug,ug
ur,ur,ur,ur,ur,ub,ur,ur,ur,ug,ur,ur,ur,ur,ur,ur,ur,ur,ur,ur,ur,ug,ug
ug,ur,ur,ur,ur,ub,ur,ur,ug,ug,ur,ur,ur,ur,ur,ur,ur,ur,ur,ur,ur,ug,ug
ug,ur,ug,ug,cb,ug,ug,ug,ug,ug,ur,ur,ur,ur,ur,ur,ug,ur,ur,ur,ur,ug,ug
ur,ur,ub,ub,ub,ub,ug,ur,ur,ur,ur,ur,ur,ur,ur,ur,ur,ur,ur,ur,ur,ug,ur
ur,cr,ur,ub,ub,ub,ug,ur,ur,ub,ur,ur,ur,ug,ug,ur,ur,ur,ur,ur,ur,ug,ur
cg,ug,ug,ub,ub,ub,ub,ub,ur,ub,ur,ub,ub,ug,ug,ur,ug,ug,ug,ug,ug,ug,ur
cb,ug,ug,ur,ub,ug,ub,ur,ur,ur,ur,ug,ub,ug,ug,ur,ug,ur,ur,ur,ur,ur,ur
ur,ur,ug,ur,ub,ug,ub,ub,ub,ur,ur,ug,ub,ub,ub,ur,ub,ur,ur,ur,ur,ur,ur
ur,ug,cr,ur,ur,ur,ur,ur,ur,ur,ur,ub,ur,ur,ub,ub,ub,ur,ur,ur,ur,ur,ur
ur,ur,cg,ub,ur,ug,ub,ug,ur,ur,ur,ub,ur,ur,ub,ub,ub,ur,ur,ur,ur,ur,ur
ug,ug,ub,ub,ur,ug,ub,ug,ug,ug,ur,ub,ub,ur,ub,ub,ub,ur,ur,ur,ur,ur,ur
cb,cb,ub,ub,ur,ug,ub,ur,ur,ur,ur,ur,ur,ur,ur,ub,ur,ur,ur,ur,ur,ur,ur
ub,ub,ub,ub,ur,ug,ub,ur,ur,ur,ur,ur,cg,ur,ur,ur,ur,ur,ur,ur,ur,cr,cb
cb,ub,ub,ub,ur,ug,cr,cr,cr,ur,ur,cg,cb,ur,ur,ur,ur,ur,ur,cr,ur,cr,cb