ur,ur,cr,ur,ur,ur,ur,cb,cb,cb,cg,ur,cg,ur,ur,ur,ur,ur,ur,ur,cb,ur,cb
ur,ur,ur,ur,ur,ur,ur,cg,ur,ur,ur,ur,ur,ur,ur,ur,ur,ur,ur,ug,ug,ug,ug
ur,ur,ur,ur,ur,cr,cr,ug,ur,ub,ug,ug,cr,ur,ur,ur,ur,ub,ub,ub,ub,ur,ug
cb,ug,ug,ug,ug,cg,ur,ur,ur,ub,ub,ub,ug,ug,ur,ub,ur,ub,ub,ub,ub,ug,ug
ur,ur,ur,ur,ur,ur,ur,ur,ux,ug,cg,ug,ug,ug,ur,cr,ur,cb,ug,ug,ug,ug,ug
ur,ur,ur,ur,ug,ug,ug,ur,ur,ug,ub,ug,ug,ug,ur,ur,ug,ur,ur,ur,ur,ur,ug
ur,ur,cr,ug,ug,ug,ug,ub,ur,ug,ug,ug,ub,ug,ur,ug,ug,ur,ug,ug,ug,ub,ug
ur,ug,ug,ug,ug,ug,ub,ub,ur,ug,ug,ug,ug,ug,ub,ug,ug,ur,ug,ug,ug,ub,ug
ur,ur,ur,ub,ux,ux,ux,ux,ur,ub,ub,ug,ug,ug,ug,ug,ug,ur,ug,ug,cr,ub,cg
ur,ur,ur,ub,ux,ux,ux,ux,ur,ub,ub,ux,ub,ug,ug,ug,ug,ur,ug,ug,ur,ub,ur
ur,ur,ur,ub,ux,ux,ux,ux,ur,ub,ub,ux,ub,ug,ug,ug,ug,ug,ug,ug,ur,ub,ur
ur,ur,ur,ub,ub,ub,ub,ub,ur,ug,ub,ug,ub,ug,ug,ug,ug,ug,ug,ug,ur,ub,ur
ur,ur,ur,ux,cb,ub,ub,ub,ub,ub,ub,ub,ub,ug,ug,ug,ug,ug,ug,ug,cb,ub,ur
ur,ur,ur,ux,ub,ub,ux,ug,ug,cg,ux,ub,ub,ug,ug,ug,ug,ug,ur,ug,ub,ub,ur
ur,ur,ur,ux,ux,ux,ux,ug,ug,ug,ub,ub,ub,ug,ug,ug,ux,ug,ur,ux,ub,ub,ur
ur,ur,ur,ur,ur,ur,ub,ub,ur,ub,ub,ur,ub,ub,cb,ug,ug,ug,ur,ux,ub,ub,ur
ur,ur,ur,ur,ur,ur,ur,ur,ur,ub,ur,ur,ur,ur,ur,ur,ur,ur,ur,ux,ub,ub,ur
ur,ur,ur,ur,ur,ur,ur,ur,ur,ur,ur,ur,ur,ur,ur,ur,ur,ux,ux,cr,ur,ur,ur
ub,ub,ur,ub,ub,ux,ux,ub,ub,ur,ur,ur,ur,ur,ur,ur,ur,ux,ur,ur,ur,ub,cb
cg,ub,ub,ub,ub,ub,ub,ub,ub,ur,ur,ur,ur,ur,ur,ur,ux,ux,ur,ux,ux,ub,ub
cb,ub,ub,ub,ub,ur,cb,ub,ub,ur,ur,ur,ur,ur,ur,ur,ur,ux,ur,ur,ux,ub,ub
ux,ub,ub,ub,ub,ur,ub,ub,ub,ub,ux,ux,cg,ux,ux,ux,ur,ur,ur,ur,ux,cr,cb
ub,ur,ur,ur,ur,ur,cr,ub,cr,ux,ux,cg,cb,ux,ux,ux,cr,ux,ux,cr,ux,cr,cb