ur,ur,cr,ur,ur,ur,ur,cb,cb,cb,cg,ur,cg,ur,ur,ur,ur,ur,ur,cb,cb,ux,cb
ur,ur,ur,ur,ur,ug,ug,ur,ur,ur,ur,ur,ur,ur,ur,ur,ur,ur,ur,ur,ur,cb,cb
ur,ur,ur,ug,ug,cg,cr,ur,ug,cr,ur,ur,ur,ur,ur,ur,ur,ur,ux,cr,ur,ux,ux
cg,ug,ug,cr,ur,cg,ur,ur,cg,ur,ur,ub,ur,cr,ur,ur,ur,ur,ub,ur,ub,ub,ub
ur,ug,ug,ug,ur,ur,ur,ur,ur,ur,ur,ub,ur,ur,ur,ur,ur,ur,ur,ur,ub,ub,ub
ur,ur,ur,ur,ur,ur,ur,ug,ug,ug,ur,ub,ur,ur,ur,ur,ur,ur,ur,ur,ur,ur,ux
ur,ur,ur,ug,ug,ur,ur,ur,ub,ug,ug,ub,ub,ub,cb,ub,ub,ub,ub,ub,ur,ur,ur
ux,ux,ux,ux,ug,ug,ug,ug,ub,ub,ur,ub,ub,ub,ub,ub,ug,ug,ug,ur,ur,ux,ur
ux,ux,ux,ux,ug,ug,ub,ux,ux,ub,ur,ux,ux,ux,ux,ux,ux,ux,ux,ub,ur,ur,ur
ux,ux,ux,ux,ux,ux,ub,ub,ub,ub,ub,ub,ub,ub,ub,ub,ux,ux,ux,ub,ur,ur,ur
ux,ux,ux,ux,ux,ux,ub,ug,ug,ug,cb,ug,ug,ug,ug,ub,ug,ug,ug,ug,ug,ur,ub
ux,ub,ub,ub,ub,ux,ub,ub,ub,ub,ub,ub,ug,ug,ug,ug,ug,ug,ug,ur,cg,ur,ub
ub,ub,ub,ub,ub,ub,ub,ug,ub,ub,ub,ub,ub,ug,ub,ug,ug,ug,ug,ur,ub,ur,ub
ub,cr,ur,ur,cb,ub,ub,ub,ub,ug,ub,ug,ug,ug,ug,ug,ug,cb,ux,ur,ub,ur,ur
ub,ub,ub,ub,ub,ux,ux,ux,ug,ug,ug,ux,ug,ug,ug,ug,ug,ub,ug,ur,ub,ur,ub
ub,ub,ub,ub,ub,ux,ux,ux,ug,ug,ug,ub,ug,ug,ug,ug,ug,ub,ub,ub,ub,cr,ub
ub,ub,ux,ub,ub,ux,ux,ux,ug,ug,ug,ug,ug,ug,ug,ug,ug,ub,ub,ur,ur,ux,ur
ub,ub,ux,ur,ux,ux,ux,ux,ux,ux,ub,ub,ub,ug,ug,ug,cg,ux,ux,ur,ur,ur,ur
ux,ux,ux,ur,ux,ux,ux,ux,ux,ux,ux,ub,ub,ub,ug,ug,ux,ux,ux,ur,ux,ux,cb
cg,ux,ux,ur,ux,ux,ux,ux,ux,ux,ux,ur,cb,ub,ub,ub,ub,ub,ur,ur,ux,ux,ux
cb,ux,ux,ur,ux,ur,ur,ur,ur,ur,ur,ur,ur,ub,ub,ub,ub,ub,ur,ur,ur,ur,ux
ur,ur,ur,ur,ux,ur,ur,ur,ur,ur,ur,ur,cg,ub,ub,ub,ux,ux,ux,ux,ux,cr,ux
ur,ur,ur,ur,ur,ur,cr,ux,cr,ux,ux,cg,cb,ub,ub,ub,cr,ux,ux,cr,ux,cr,cb