ur,ur,cr,ub,cb,ur,ur,cb,cb,cb,cg,ur,cg,ux,ux,ux,ux,ux,ux,cb,cb,ur,cb
ur,ur,ur,ur,ur,ur,ur,ur,ur,ur,ur,ur,ur,ur,ur,ur,ur,ur,ur,ur,ur,cr,ub
ur,ur,cr,ur,ug,cg,ur,ur,ur,ur,ur,cr,ub,ub,ub,cr,ur,ub,ur,ur,ub,ub,ub
ur,ur,ur,ug,ur,ug,ur,ur,ur,ub,ub,ub,ux,ux,ux,ux,cb,ub,ux,ux,ur,ur,ub
ur,ur,ur,ug,ug,ur,ub,ub,ub,ub,ub,ub,ug,ur,ub,cb,ur,ux,ux,ux,ur,ur,ub
cr,ug,ug,ug,ug,cg,ur,ub,ub,ub,ub,ug,ub,ub,ub,ub,ub,ux,ux,ux,cb,ur,ub
ug,ug,ur,ug,ug,ur,ub,ub,ub,ug,ub,ub,cg,ur,ub,ur,ub,ur,ur,ur,ub,ub,ub
ug,ug,ux,ug,ug,ug,ug,ub,ub,ub,ur,ub,ug,ub,ub,ux,cb,ur,ux,ux,ur,ub,ub
ug,ur,ur,ur,ug,ub,ub,ub,ub,ug,ug,ug,ug,ub,ub,ub,ur,ur,ur,ur,ur,ub,ub
ug,ur,ug,ur,ug,ub,ux,ux,ub,ug,ug,ug,ub,ug,ub,ub,ug,ug,ug,ur,ur,ub,ub
ug,ur,ug,ur,ub,ub,ux,ux,ux,ux,ux,ug,ub,ug,ug,ub,ub,ug,ug,ug,ur,ub,ub
cg,ur,ug,ur,ub,cr,ur,ur,ur,ur,ur,ur,ur,ur,ur,ur,ur,ur,ug,ug,ur,ub,ub
ux,ur,ux,ur,ug,ub,ux,ux,ux,ub,ux,ux,ub,ub,ub,ug,ug,ug,cg,ug,ug,ur,ur
ux,ur,ux,ur,ux,ub,ub,ub,ub,ub,ub,ub,ub,ub,ub,ug,ug,ug,ug,ug,cb,ub,ur
ux,ur,ux,ur,ur,ur,ur,ur,ur,ub,ub,ub,ub,ur,ub,ub,ur,ur,ur,ub,ub,ur,ur
ux,ur,ur,ur,ur,ur,ur,ur,ub,ub,ub,ub,ub,ur,ur,ub,ub,ub,ub,ub,ub,ur,ur
ux,ux,ux,ux,ux,ux,ux,ux,ub,ub,ux,ux,ux,ur,ux,ur,ux,ux,ux,ux,ur,ur,ur
ux,ux,ux,ux,ux,ux,ux,ux,ug,ug,ux,ux,ux,ur,ux,ur,ux,ux,ux,ux,ub,ur,ur
ux,ux,ux,ux,ux,ub,ub,ub,ug,ug,ub,ub,ub,ur,ub,ur,ub,ub,ub,ub,ub,ur,cb
cg,ux,ux,ux,ux,ub,ux,ux,ux,ux,ux,ux,ux,ur,ux,ur,cr,ur,ur,ur,ur,ur,ur
cb,ux,ux,ux,ux,ub,ux,ux,ux,ux,ux,ux,ux,ur,ux,ur,ux,ux,ux,ux,ux,ur,ur
ux,ux,ux,ux,ux,ux,ux,ux,ux,ux,ux,ux,cg,ur,ux,ur,ux,ux,ux,ux,ux,cr,ur
ux,ux,ux,ux,ux,ux,cr,ux,cr,ux,cb,cg,cb,ur,ur,ur,cr,ux,ux,cr,ux,cr,cb