cr,ux,cr,ub,cb,ub,ub,cb,cb,cb,cg,cg,cg,ur,ur,ur,ur,ur,ur,ur,cb,cb,cb
ux,ux,ux,ux,ux,ux,ux,ux,ux,cr,ur,ur,ub,ub,ub,cr,ur,ur,ux,ur,ur,ur,ur
ux,cr,ug,ug,ug,ug,ug,ug,ug,ur,ug,ug,ug,ug,ug,cg,ub,ub,ur,ur,ur,ur,ur
ux,ux,ug,ux,ux,cr,ux,ux,ux,ur,ur,ur,ur,ub,cr,ub,ub,ub,ur,ur,ur,ur,ur
ur,ur,ug,ur,ug,ur,ug,ug,ux,ux,ur,ur,ur,ur,ur,ub,cb,ub,cb,ur,ur,ur,ur
ur,ur,ug,ur,ug,ur,ug,ug,ux,ur,ur,ur,ur,ub,ub,ub,cr,ur,ur,ur,ur,ur,ur
ux,ux,ug,ur,cg,ur,ur,ur,ur,ur,ur,ur,ur,ur,ur,ur,ur,ux,ux,ux,ux,ux,ux
ux,ux,ug,ur,ur,ur,ur,ur,ur,ur,ur,ur,ur,ur,ux,ug,ug,ug,ug,ug,ux,ux,ux
ux,ux,ug,ux,ux,ux,ux,ux,ux,ux,ur,ur,ux,ux,ux,ux,ux,ux,ug,ug,ux,ux,ux
ux,ux,ug,ux,cg,ug,ug,ug,ux,ux,ub,ub,ub,ub,ux,ux,ux,ux,ux,ux,ux,ux,ux
ux,ux,ug,ux,ug,ug,ug,ug,ux,ub,ub,ub,ub,ub,ux,ux,ux,ux,ux,ux,ux,ux,ux
ur,ur,ur,ur,ug,ur,ur,ur,ur,ur,ub,ub,ub,ub,ub,ux,ux,ux,ux,ux,ux,ux,ux
ur,ux,ug,ug,ug,ug,ug,ur,ur,ur,ub,ub,ub,ub,ub,ux,ux,ux,ux,ux,ux,ux,ux
ur,ux,ug,ug,ug,ug,ug,ug,ub,ub,cb,ub,ub,ub,ub,ub,ub,ux,ux,ux,ux,ux,ux
cr,ux,ug,ug,ug,ur,ug,ug,ug,ug,ug,cb,ux,ur,ux,ub,ub,ux,ux,ux,ux,ux,ux
ux,ux,ux,cr,ur,ur,ur,ug,cg,ur,ur,ur,ug,ug,ug,cg,ub,ug,ug,ux,ux,ux,ux
ux,ux,ux,ux,ub,ug,ub,ug,ub,ub,ug,ug,ug,ug,ux,ug,ub,ub,ug,ug,ux,ux,ux
ux,ux,ux,ux,ux,ug,ug,ug,ub,ub,ug,ug,ux,ug,ux,ug,ux,ub,ux,ux,ux,ux,ux
ux,ux,ux,ux,ux,ur,ub,ub,ub,ub,cb,ub,ux,ux,ux,ug,ux,ub,ux,ux,ux,ux,cb
cg,ux,ux,ux,ux,ur,ux,ux,ux,ux,ux,ux,ux,ux,ux,ux,ux,ub,ux,ux,ux,ux,ux
cb,ux,ux,ux,ux,ur,ux,ux,ux,ux,ux,ux,ux,ux,ux,ux,cb,ub,ux,ux,ux,ux,ux
ux,ux,ux,ux,ux,ux,ux,ux,ux,ux,ux,ux,cg,ux,ux,ux,ux,ux,ux,ux,ux,cr,cb
cb,ux,ux,ux,ux,ux,cr,cb,cr,ux,ux,cg,cb,ux,ux,ux,ux,ux,ux,cr,ux,cr,cb