ub,ub,cr,ur,ur,ur,ur,cb,cb,cb,ur,ur,cg,ur,ur,cb,ux,ux,ur,cb,cb,ux,cb
cr,ub,ub,ur,cb,ur,ur,ur,ur,ur,ur,ur,ur,cr,ur,ur,ur,ur,ur,ux,ux,ux,cb
ur,ug,ub,ub,ub,ur,ur,ur,ub,ub,ub,cg,ur,ur,ub,ur,ur,ur,ur,ur,ux,ux,ux
ur,ug,ug,ur,ur,ur,ur,ur,ub,ur,ur,ug,ur,ur,ub,ub,ur,ur,ur,ub,ux,ux,ux
ur,ur,ug,ug,ur,ur,ur,ur,ub,ub,cb,ur,cr,ur,ur,ub,ub,cb,ur,ur,cr,ux,ux
ub,ug,cg,ur,ur,ur,ur,ur,ur,ur,ur,ur,ur,ur,ur,ur,ub,ub,ub,ux,ux,ux,ux
cr,ur,ur,ur,ur,ur,ux,ux,ux,ux,ur,ur,ur,ur,ur,ug,ug,ux,ux,ux,ux,ux,ux
ub,ux,ux,ux,ug,ur,ur,ug,ug,ug,ub,ub,ub,ub,ub,ux,ux,ux,ur,ur,ur,ur,ux
ub,ux,ux,ux,ug,ug,ug,ug,ux,ub,ub,ub,ub,ux,ub,ug,ug,ug,ug,ug,ug,ur,ux
ub,ux,ux,ux,ux,ux,ur,ur,ub,ub,ub,ub,cb,ub,cg,ug,ux,ug,ug,ug,ug,ur,ux
ub,ux,ux,ux,ux,ux,ug,ug,ub,ub,ub,ur,ub,ub,ux,ug,ug,ug,ug,ug,ug,ur,ux
ub,ub,ub,ub,ub,ub,ub,ug,ub,ub,ub,ub,ub,ug,ux,ug,ug,ug,ug,ug,ug,ux,ux
ub,ub,ub,ub,ub,ub,ub,ug,ub,ub,ub,ux,ux,ug,ug,ug,ug,ug,ug,ug,ug,ux,ux
ub,ux,ux,ux,ug,ug,ug,ug,ug,ug,ux,ux,ux,ux,ux,ur,ug,ug,ug,ug,ur,ur,cg
ub,ux,ux,ux,ug,ug,ug,ub,ub,ub,ub,ux,ux,ux,ux,ur,ur,ur,ux,ux,ux,ur,cr
ub,ux,ux,ux,ug,ug,ug,ug,ur,ub,ub,ug,ug,ug,ug,cr,ug,ug,ur,ur,ur,ur,ur
ub,ux,ux,ub,ub,ub,ub,ug,ux,ub,ub,ug,ug,ug,ug,ur,ug,ug,ur,ur,ur,ur,ur
ub,ub,ux,ub,ug,ux,ub,ub,ug,ub,ub,ug,ug,ug,ug,ur,ug,ug,ug,ug,cg,ur,ur
cg,ub,ux,ub,ug,ug,ug,ub,ub,ub,ub,cb,ub,ub,ug,ur,ug,ug,ug,ug,ub,ur,ur
cg,ub,ux,ub,ug,ug,ug,ux,ub,ub,ub,ur,ub,ub,ug,ur,ug,ug,ug,ug,ub,ur,ur
cb,ub,ux,ub,ux,ux,ur,ur,ur,ur,ub,ub,ub,ub,ur,ur,ur,ur,ur,ur,ur,ur,ur
ub,ub,ux,ub,ux,ux,ur,ur,ur,ur,ur,ur,cg,ur,ur,ur,ur,ur,ur,ur,ur,cr,ux
ub,ub,ub,ub,ux,ux,cr,ux,cr,ux,ux,cg,cb,ur,ur,ur,cr,ux,ux,cr,ur,cr,cb