ur,ur,cr,ug,ug,ug,ur,cb,cb,cb,cr,cg,cg,ur,ur,ur,ub,ur,ur,ur,cb,cb,cb
cg,ub,ub,ub,ug,ug,ub,ub,ur,ub,ur,ur,ur,ur,ub,ur,ur,ur,ur,ur,ug,ug,ug
ug,ug,ug,ug,ug,ug,ug,ug,ur,ug,ug,ug,ug,ub,ub,ur,ur,ur,ur,ur,ub,ub,ub
ug,ug,ug,ug,ug,ug,ug,ub,ur,ub,ub,ub,ub,ub,ub,ub,ub,ub,ub,ur,ub,ub,ub
ug,ug,ug,ug,ug,ug,ug,ub,ur,ub,cb,ur,ug,ub,ur,ur,ur,ur,ur,ur,ub,ub,ub
ug,ug,ug,ug,cg,ug,ug,ug,cr,ug,ug,ur,ur,ur,ub,ub,ub,ub,ub,ub,ub,ub,ub
cg,ug,ug,ug,ug,ug,ug,ug,ur,ug,ub,ub,ug,ur,ur,ur,ur,ur,ur,ur,ub,ub,ub
ub,ug,ug,ug,ug,ug,ug,ug,ug,ug,ub,ub,ub,ur,ub,ub,ub,ub,ug,ur,ur,ur,ub
ug,ug,ug,ug,ub,ur,ur,ub,ub,ub,ub,ub,ug,ur,ug,ug,ur,ur,ur,ur,ub,ur,ub
ug,ug,ug,ug,ub,ub,ub,ub,ur,ur,ur,ub,ur,ur,ug,ug,ub,ub,ub,ur,ub,ur,ub
ug,ug,ug,ug,ub,ug,ug,ug,ur,ur,ur,cb,ur,ur,ug,ug,ug,ur,ur,ur,ur,ur,ub
ug,ug,ug,ur,ur,ur,ur,ur,ug,ug,ug,ub,cb,ug,ug,ug,ub,ur,ub,ur,ub,ur,ub
ug,ub,ug,ug,ur,ug,ug,ug,ug,ur,ur,ug,ub,ub,ub,ug,ug,ur,ug,ur,ub,ub,ub
cg,ub,ub,ub,ub,ub,ub,ub,ub,ub,ur,ub,ub,ub,cg,ug,ug,ur,ub,ur,ur,ur,ub
cg,ub,ug,ug,ur,ub,ub,ub,cb,ub,ub,ub,ur,ur,ur,ur,ur,ur,ug,ur,ub,ub,ub
ug,ub,ug,ub,ur,ub,ub,ub,ub,ub,ur,cr,ur,ub,ub,ur,ug,ug,ug,ur,ub,ub,ub
ug,ub,ug,ug,ur,ug,ug,ub,ub,ur,ur,ur,ub,ub,ub,ub,ur,ub,ug,ur,ur,ur,ub
ug,ug,ub,ub,ur,ub,ub,ur,ur,ur,ur,ub,ub,ub,ub,ug,ug,ug,ug,ur,ur,ur,ub
ug,ug,ug,ub,ur,ub,ug,ub,ur,ur,ub,ub,ub,ub,ub,ub,ub,ub,ur,ur,ur,ur,ub
ug,ug,ug,ug,ur,ug,ug,ub,ur,ur,ub,ub,ub,ub,ub,ub,ub,ub,ub,ur,ub,ub,ub
cb,ug,ug,ug,ur,cr,ug,ub,ur,ur,ug,ub,ub,ub,ub,ub,ub,ug,ur,ur,ur,ur,ug
ug,ug,ug,ug,ur,ur,ug,ug,ur,ur,ug,ub,cg,ub,ub,cb,ub,ug,ur,ur,ur,cr,cb
cb,ug,ug,ug,ur,ur,cr,ug,ur,ur,ur,cg,cb,ub,ub,cb,ur,ur,ur,cr,ub,cr,cb