ur,ur,cr,ur,ur,ur,ur,cb,cb,cb,cg,ur,cg,ux,ur,ur,ur,ur,ug,cb,cb,ux,cb
ur,ur,cr,ur,ur,ur,ur,ur,ur,ur,ur,ur,cr,ur,ur,ug,ux,ur,ug,ux,ux,ux,ux
ur,ur,ur,ug,cr,ur,ur,ur,ur,ur,ur,ur,ur,cb,ur,ur,ur,ur,ug,ux,ux,ux,ux
cg,ur,ug,ug,ur,ur,ur,ur,ur,ur,ur,ur,ux,ub,ub,ub,ur,ur,ug,ux,ux,ux,ux
ub,ug,ug,cg,ur,ur,ur,ur,ur,ur,ur,ur,ur,ur,ux,ub,ur,ur,ug,ux,ux,ux,ux
ub,cg,ur,ur,ur,ur,ur,ux,ur,ux,ur,ur,ub,ub,ub,ub,ur,ur,ug,ux,ux,ux,ux
cb,ur,cr,ug,ur,ur,ur,ur,ur,ur,ur,ur,ub,ur,ur,ux,ug,ug,ug,ux,ux,ux,ux
ur,ur,ur,ub,ur,ur,ur,ur,ur,ug,ug,ub,ub,ux,ur,ux,cg,ug,ug,ux,ux,ux,ux
ur,ur,ub,ub,ub,ub,ur,ub,ur,ub,ur,cr,ub,ur,ur,ux,ug,ug,ug,ug,ug,ug,ux
ur,ur,ub,ub,ur,ub,ur,ub,ub,ub,ur,ug,ub,ub,ub,ug,ug,ug,ug,ug,ug,ug,ug
ur,ur,cr,ub,ub,ub,ux,ug,cb,ub,ur,ug,ub,ub,ub,ug,ug,ug,ux,ux,ug,ug,ug
cg,ub,ub,ub,ux,ur,ur,ur,ub,ur,ur,ug,ug,ub,ub,ub,ug,ug,ug,ug,ug,ug,ug
ux,ub,ux,ux,ux,ur,ur,ug,ub,ub,ur,ub,ug,ug,ub,ub,ug,ug,ug,ug,ug,ug,ug
ux,ub,ux,ux,ux,ur,ur,ug,ux,cg,ug,ug,ug,ug,ug,ug,ur,ur,ur,ur,ur,ur,ur
ux,cb,ux,ux,ux,ur,ur,ur,ur,ur,ub,ug,ug,ug,ub,ug,ug,ug,ug,ux,ub,ub,ub
ux,ux,ux,ub,ub,ur,ur,ug,ur,ur,ub,ub,ug,ug,ug,ug,ux,ux,ub,ub,ub,ub,ub
ux,ux,ux,ub,ub,ub,ux,ub,ur,ur,ub,ub,ub,ub,ug,ug,ux,ux,ub,cb,ub,ub,ur
ux,ux,ux,ub,ux,ub,ux,ub,cr,ub,cb,ub,ux,ux,ux,ug,ux,ux,ub,ub,ub,ur,ur
ux,ub,ub,ub,ux,ub,ux,ub,ug,ur,ub,ub,ux,ux,ux,ug,ux,ux,ub,ub,ub,ub,cb
cg,ub,ub,ub,ux,ub,ux,ub,ug,ur,ug,ub,ug,ug,ug,ug,ux,ux,ux,ux,ub,ub,ux
cb,ub,ub,ub,ux,ub,ux,ub,ur,ur,ub,ub,ux,ux,ux,ux,ux,ux,ux,ux,ux,ux,ux
ub,ub,ub,ub,ub,ub,ub,ub,ur,ur,ub,ub,cg,ux,ux,ux,ux,ux,ux,ux,ux,cr,ux
cb,ub,ub,ub,ub,ur,cr,ur,cr,ur,ur,cg,cb,ux,ux,ux,cr,ux,ux,cr,ux,cr,cb