cr,ux,cr,ub,cb,ub,ub,cb,cb,cb,ub,cg,cg,ur,ur,ur,ur,ur,ur,cr,cb,cb,cb
ur,ur,ur,ur,ur,ur,ur,ur,ur,ur,ub,ur,ur,ur,ux,ux,ux,ux,ux,ux,ux,ux,ux
ur,cr,ux,ur,ur,ur,ur,ur,ur,ur,ub,ub,ub,ux,ux,ux,ux,ux,ux,ux,ux,ux,ux
ur,ux,ur,ur,ur,ur,ur,ur,ur,ur,ux,ux,ub,ub,ux,ux,ux,ux,ug,ug,ug,ug,ug
ur,ux,ur,ur,ur,ur,ur,ur,ur,ur,ux,ux,cb,ub,ug,ug,ug,ux,ug,ux,ux,ux,ug
ur,ur,ur,ur,cr,ur,ux,cr,ur,ur,ux,ux,ub,ub,ux,ux,ug,ux,ug,ug,ug,ux,ug
ur,ur,ur,ur,ux,ux,ug,ug,ug,ur,ug,ug,ug,ur,ur,ur,ug,ux,ux,ux,ug,ux,ug
ug,ux,ux,ux,ux,ux,ux,ux,ur,ur,ur,ur,ur,ur,ur,ur,ug,ug,ug,ug,ug,ur,ug
ug,ux,ux,ux,ux,ux,ux,ux,ur,ur,ur,ur,ur,ur,ur,ur,ur,ur,ug,ug,ug,ur,ug
ug,ux,ux,ux,ux,ux,ux,ux,ur,ur,ur,ur,ur,ur,ur,ur,ur,ur,ug,ur,cg,ur,ug
ug,ux,ux,ux,ux,ux,ux,ux,ux,ur,ur,ur,ur,ur,ur,ur,ur,ur,ug,ug,ug,ug,ug
ug,cb,ux,ux,ux,ux,ux,ux,cr,ur,ur,cr,ur,ur,ug,ug,ug,ug,ux,ux,cg,ur,ub
ug,ub,ub,ub,ub,ux,ux,ux,ux,ub,ub,ub,ub,cb,ug,ug,ug,ug,ug,ur,ur,ur,ub
ug,ux,ub,ub,ub,ux,ux,ux,ux,ux,ur,ur,ux,ug,ug,ux,ux,ux,ug,ub,ub,ub,ub
ug,ub,ub,ub,ub,ux,ux,ux,ux,ux,ur,ur,ux,ug,ug,ug,ug,ug,ug,ub,ux,ux,ux
ug,ub,ub,ub,ux,ux,ux,ux,ux,ux,ur,ur,ux,ug,ug,ug,ug,ug,ug,cg,ux,ux,ux
ug,ub,cg,ug,ug,ug,ux,cb,ux,ux,ur,ur,ux,ux,ux,ux,ux,ux,ub,ux,ux,ux,ux
ug,cg,ug,ux,ux,ug,ux,ub,ug,ub,ur,ur,ux,ux,ux,ux,ux,ux,ub,ux,ux,ub,cg
ug,ug,ug,ux,ux,ug,ug,ub,ug,ub,ur,ur,ux,ux,ux,ux,ux,ub,ub,ux,ub,ub,cb
cg,ux,ux,ux,ux,ug,ug,ub,ug,ub,ur,ur,ur,ur,ur,ur,ur,ur,ur,cr,ub,cb,ux
cb,ux,ux,ux,ux,ug,ux,ub,ub,ub,ur,ux,ux,ux,ub,ub,ub,cb,ux,ux,ux,ux,ux
ux,ux,ux,cr,ur,ur,ur,ur,ur,ur,ur,ux,cg,ux,ux,ub,ux,ux,ux,ux,ux,cr,cb
cb,ux,ux,ux,ux,ug,cr,cb,cr,ur,ur,cg,cb,ub,ub,ub,ux,ux,ux,cr,ux,cr,cb