ur,ur,cr,ur,ur,ux,ux,cb,cb,cb,ug,ux,cg,ur,ur,cb,ur,ur,ur,cb,cb,ur,cb
ur,ur,ug,ur,ur,cr,ur,ur,ur,ur,cr,ux,ux,ur,ur,ur,ug,ug,ur,ur,ur,ur,cb
ur,ur,ug,ur,ur,ug,ur,ur,ur,ur,ur,ur,ur,ur,ux,ur,cr,cg,cr,ur,ur,ur,ur
ur,ur,ur,ur,ur,ug,ur,ur,ur,ur,ur,ur,ur,ur,ug,ug,ur,ub,ub,cb,ur,ur,ur
ug,ug,ug,ug,ur,cg,ur,ur,ur,ur,ur,ur,ur,ur,ug,ur,ur,ur,ur,ur,ur,ur,ur
ur,ur,ur,ur,ur,ur,ur,ur,ur,ur,ur,ur,ur,ub,ub,ur,ur,ub,ub,ub,ub,ub,ur
ur,ur,ur,ur,ur,ur,ur,ur,ur,ur,ub,ur,cb,ub,ub,ub,ub,ub,ux,ug,ub,ub,ub
ur,ur,ur,ur,ur,cr,ur,ur,ur,ur,ub,ub,ub,ur,ub,ub,ug,ur,ux,ug,ub,ub,ub
ur,ur,ur,ur,ur,ur,ur,ug,ur,ub,ub,ur,ub,ur,ur,ur,ur,ur,ub,ub,ur,ub,ub
ur,ur,ur,ur,ur,ur,ug,ub,ub,ub,ug,ur,ub,ur,ur,ur,ur,ur,ub,ub,ub,ub,ub
ur,ur,ur,ur,ur,ur,ug,ub,cb,ur,ug,ub,ug,ur,ur,ur,ur,ug,ug,ub,ub,ub,ub
ur,ur,ur,ur,ur,ur,ug,ur,ur,ug,ug,ug,ug,cg,ub,ub,ub,ug,ug,ub,ub,ub,ub
ur,ur,ur,ur,ur,ug,ug,ub,ub,ug,ug,ug,ub,ug,ub,ux,ub,ux,ug,ur,ub,ur,ur
ur,ur,ur,ur,ur,cg,ur,ub,ux,ug,ug,ug,ug,ug,ub,ux,ub,ux,ug,ux,ub,ub,cg
ur,ur,ux,ur,ur,ur,ur,cr,ug,ug,ub,ug,ug,ug,ub,ug,ub,ux,ug,ux,ub,ub,ub
ur,ur,ur,ur,ur,ub,ux,ux,ux,ug,ug,ub,ug,ug,ub,ug,ub,ub,ug,ub,ub,ub,ub
ur,ur,ur,ur,ur,ub,cr,ub,ub,ub,ub,ub,ub,ub,ub,ug,ug,ug,ug,ub,ub,ub,ub
ux,ux,ux,ub,ub,ub,ur,ub,ub,ub,ub,ub,ub,ub,ux,ux,ug,ug,ug,ub,ub,ub,ub
cg,ux,ux,ub,ub,ub,ur,ub,ub,ub,ub,ub,ug,ub,ub,ug,ug,ub,ur,ur,ub,ub,ur
cg,ur,ur,ur,ur,ur,ur,ur,ur,ur,ur,ur,ug,ug,ub,ug,ur,ur,ur,cb,ub,ur,ur
cb,ur,ux,ux,ux,ur,ux,ux,ux,ux,ux,ur,ur,ur,ub,ub,ub,ub,cb,ur,ur,ur,ur
ux,ur,ux,ux,ux,ur,ux,ux,ux,ux,ux,ux,cg,ux,ux,ux,ux,ux,ux,ux,ux,cr,ur
ux,ur,ur,ur,ur,ur,cr,ux,cr,ux,ux,cg,cb,ux,ux,ux,cr,ux,ux,cr,ux,cr,cb