ur,ur,cr,ur,ur,cr,ur,cb,cb,cb,cg,cg,cg,ur,ur,ur,ur,ur,ur,ur,cb,cb,cb
cg,ur,ur,ur,ur,ur,ur,ur,ub,ub,cr,ur,ur,ur,ur,ur,ur,ur,ur,ur,ur,ur,ur
ur,cr,ur,ur,ur,ur,ur,ur,ub,ur,ur,ur,ur,ur,ur,ur,ur,ur,ur,ur,ur,ur,ur
ub,cr,ur,ur,ur,ur,ur,ur,ub,ur,ur,ur,ur,ur,ur,ur,ur,ur,ur,ur,ur,ur,ur
ur,cb,ub,ur,ur,ur,ur,ur,cb,ur,ur,ur,ur,ur,ur,ur,ur,ur,ur,ur,ur,ub,ux
ur,ur,ur,ur,ur,ur,ur,ur,ur,ur,ur,ur,ur,ur,ur,ur,ur,ur,ur,ur,ur,ur,ur
ur,ur,ur,ur,ur,ur,ur,ur,ur,ur,ur,ur,ur,ur,ur,ur,ur,ur,ux,ur,ux,ux,ur
ur,ur,ur,ur,ur,ur,ur,ur,ur,ur,ur,ur,ur,ur,ur,ur,ur,cr,ux,ur,ub,ub,ur
ur,ur,ur,ur,ur,ur,ub,ub,ub,ug,ur,ug,ub,ug,ug,ux,ur,ux,ub,ur,ub,ub,ur
ur,ur,ur,ur,ur,ur,ub,ur,ur,ur,ur,ur,ur,ug,ug,ug,ug,ug,cg,ur,ug,ug,ur
ux,ux,ur,ur,ur,ur,ux,cr,ur,ur,ur,ub,ub,ug,ug,ug,ug,ug,ug,ur,ug,ug,ug
cb,ur,ur,ur,ur,ur,ug,ug,ug,ug,ub,ub,cg,ug,ug,ug,ug,ug,ug,cr,ug,ug,ug
ub,ur,ur,ur,ur,ur,cr,ug,ug,ug,ux,ub,ug,cb,ub,ub,ub,ug,ug,ug,ug,ug,ug
ub,ur,ur,ur,ur,cg,ur,ug,ug,ub,cb,ub,ug,ub,ub,ub,ub,ug,ug,ug,ug,ug,ub
ub,ur,ur,ur,ur,ug,ur,ur,ug,ub,ub,ub,ug,ug,ug,ub,ub,ug,ux,ux,ux,ux,ux
ub,ur,ur,ur,ur,cb,ur,ub,ug,ug,ug,ug,ug,ub,ug,ug,ur,ug,ux,ux,ux,ux,ux
ub,ur,ur,ur,ur,ub,ug,ub,ug,ug,ur,ur,ur,cg,ug,ur,ur,ux,ux,ux,ux,ux,ux
ub,ub,ub,ub,ub,ub,ub,ub,ug,ug,ux,ux,ux,ub,ub,ub,ur,ub,ub,ub,ux,ux,ux
ux,ux,ub,ux,ux,ub,ub,ub,ub,ub,ub,ub,ub,ub,ub,ub,ur,ub,ub,ub,ux,ux,cb
cg,ub,ub,ub,ub,ub,ub,ub,ux,ux,ux,ux,ux,ux,ux,ux,ur,ux,ux,ux,ux,ux,ux
cb,ub,ux,ux,ux,ub,ux,ux,ux,ux,ux,ux,ux,ux,ux,ux,ur,ux,ux,ux,ux,ux,ux
ux,ub,ux,ux,ux,ub,ux,ux,ux,ux,ux,ux,cg,ux,ux,ux,ur,ux,ux,ux,ux,cr,cb
cb,ub,ub,ub,ub,ub,cr,cb,cr,ux,ux,cg,cb,ux,ux,ux,cr,ux,ux,cr,ux,cr,cb