cg,ur,cr,cr,ug,ug,ug,cb,cb,cb,ur,cg,cg,ux,cb,cr,ur,ur,ur,ux,cb,cb,cb
ug,ur,ur,ur,ub,ub,ug,ur,ur,ur,ur,ur,ub,ub,ub,ub,ur,ub,ub,ub,ub,ub,cb
ug,cr,ur,ug,ur,ur,ug,ur,ur,ur,ur,ur,ur,ur,ur,ur,ur,ur,ur,ur,ux,ur,cr
ug,ug,ug,ug,ug,ug,ug,ur,ur,ur,cr,ug,ug,ug,ug,ur,ur,ur,ur,ur,ur,ur,ur
ux,ux,ur,ug,ug,ur,ug,ur,ur,ur,ux,ux,ux,ux,ug,ux,ux,ux,ur,ur,ux,ux,ur
cb,ux,ur,ug,ug,ux,ug,cg,ux,ur,ur,cg,ug,ug,ug,ub,ub,ub,ux,ux,ux,ux,ur
ux,ux,ur,ug,ug,ux,ux,ux,ux,cr,ur,ur,ur,ux,ub,ub,ub,ub,ux,ux,ux,ux,ur
ux,ug,ug,ug,ur,ur,ug,ux,ux,ux,ux,ux,ux,ux,ub,ub,ub,ub,ux,ux,ux,ux,ur
ur,ug,ur,ug,ur,ur,ug,ug,ug,ug,ux,ux,ux,ux,ub,ub,ux,ub,ux,ux,ux,ux,ur
ur,ug,ur,ug,ux,ug,ug,ug,ug,ug,ux,ux,ux,ux,ub,ub,ub,ub,ub,ub,ux,ux,ur
ur,ug,ug,ug,ur,ux,ux,ux,ux,ux,ux,ux,ux,ux,ub,ub,ub,ub,ub,ub,ux,ux,ur
ug,ug,ug,ug,ur,ur,ux,ux,ux,ux,ux,ux,ux,ub,ub,ub,ub,ub,ub,ub,ux,ux,ur
ug,ux,ux,ug,ux,ur,ux,ux,ux,ux,ux,ux,ux,ub,ux,ux,ux,ub,ub,ub,ux,ux,ur
ug,ux,ub,ub,ux,ur,ux,ux,ux,ux,ux,ux,ux,cb,ux,ux,ux,ub,cr,ug,ug,ux,ur
ug,cb,ub,ub,ub,ur,ux,ug,ug,ug,ux,ur,ur,ur,ux,ux,ux,ub,ur,ug,ug,ux,ur
ug,ub,ub,ub,ub,ur,ug,ug,ug,ug,ur,ur,ux,cb,ub,ub,ux,ub,ur,ug,ug,ub,ub
ug,ub,ux,ux,ur,ur,ur,ur,ug,cg,ur,ux,ux,ur,cr,ub,ug,ub,ur,ub,ub,ub,ub
ug,ug,ux,ux,ur,ur,ux,ur,ug,ug,ux,ux,ux,ux,ux,ug,ug,cg,ur,ug,ub,ub,ur
ux,ug,ux,ux,ur,ur,ux,ug,ug,ug,ux,ux,ux,ux,ug,ug,ub,ub,ur,ur,cb,ub,ur
cg,ug,ug,ux,ux,ux,ux,ug,ug,ug,ux,ux,ur,ur,ug,ug,ur,ug,ug,ug,ur,ux,ur
cb,ux,ug,ux,ux,ux,ux,ux,ux,ux,ux,ux,ux,ux,ux,ux,ux,ur,ur,ur,ur,ur,ur
ux,ux,ux,ux,ux,ux,ux,ux,ux,ux,ux,ux,cg,ux,ur,ur,ur,ur,ur,ur,ur,cr,cb
cb,ux,cg,ux,ux,ux,cr,cb,cr,ux,ux,cg,cb,ux,ur,ur,ur,ur,ur,cr,ur,cr,cb