ux,ux,cr,ux,ux,ux,ux,cb,cb,cb,cg,cg,cg,cb,ur,ur,ur,ur,ur,ur,cb,cb,cb
ux,cr,ur,ux,ux,ux,ux,cg,ur,ur,ur,ur,ur,ur,ur,cr,ur,ur,ur,ur,ur,ur,ur
ux,cr,ur,ux,ux,ux,ux,ux,cr,ux,ur,ur,ur,cr,ur,ur,ur,ur,ur,ur,ur,ur,ur
cb,ur,ur,ux,ux,ux,ux,ux,ux,ux,ur,ur,ur,ug,ur,cg,ur,ur,ur,ur,ur,ur,ur
ux,ur,ux,ux,ux,ux,ux,ux,ux,ux,ur,ur,ur,ug,ug,ug,ur,ur,ur,ur,ur,ur,ur
ug,ug,cg,ux,ur,ur,ur,ur,ur,ur,ur,ur,ur,ur,ur,ur,ur,ur,ug,ur,ur,ur,ur
ug,ur,ux,ux,ur,ur,ur,ur,ur,ur,ur,ur,ur,ur,ur,ur,ug,ug,ug,ur,ur,ux,ux
ug,ur,ur,ur,ur,ur,ur,ur,ur,ug,ug,ur,ur,cb,ub,ub,ub,ub,ug,ur,ur,ux,ux
ur,ur,ur,ur,ur,ur,ur,ur,ug,ug,ug,ub,ub,ub,ub,ub,ub,ub,ug,ur,ur,ux,ux
ur,ur,ur,ur,ug,ug,ug,ug,ug,ur,cg,ur,ub,cr,ug,ug,ur,ur,ur,ux,ux,ux,ux
ur,ur,ur,ur,ug,ug,ug,ur,ur,ur,ur,ur,ur,ur,ug,ub,ur,ur,ur,ur,ux,ux,ux
ur,ur,ur,ur,ur,ur,ur,ur,ur,ur,ug,ug,ug,ug,ug,ub,ur,ub,ub,ur,ur,ur,ur
ur,cr,ux,ux,ug,ug,ur,ur,ur,ur,ug,ug,ur,ug,ub,ug,cb,ub,ub,ux,ur,ux,ur
ur,ux,ux,ug,ug,ug,ug,ug,ug,ug,cb,cg,ur,ug,ub,ub,ub,ub,ub,ub,ur,ub,ur
ur,ux,ux,ux,ug,ug,ur,ur,ur,ug,ug,ug,ug,ug,ug,ug,ug,ub,ub,ub,ur,ub,ur
ur,ux,ux,ux,ug,ug,ur,ur,ur,ub,ub,ub,ug,ub,ub,ux,ux,ux,ub,ub,ur,ub,ur
ur,ux,ux,ux,ux,ur,ur,ur,ur,ur,ug,ug,ur,ux,ux,ux,ux,cr,ur,ur,ur,ux,ur
ur,ux,ux,ux,ux,ur,ur,ur,ur,ur,ux,ur,ur,ur,ur,ur,ur,ur,ur,ur,ur,ur,ur
ur,ur,ur,ur,ur,ur,ur,ur,ux,ur,ux,ur,ux,ux,ux,ux,ux,ux,ux,ux,ux,ux,cb
cg,ux,ux,ux,ux,ur,ur,ur,ux,ur,ux,ur,ur,ur,ur,ur,ur,ur,ur,ur,ur,ur,ur
cb,ux,ux,ux,ux,ur,ur,ur,ux,ur,ur,ur,ur,ur,ur,ur,ur,ur,ur,ur,ur,ur,ur
ur,ur,ur,ux,ux,ur,ur,ur,ux,ux,ux,ux,cg,ux,ux,ux,cb,ux,ux,ux,ux,cr,cb
cb,ur,ur,ur,ur,ur,cr,cb,cr,ux,ux,cg,cb,ux,ux,ux,cr,ux,ux,cr,ux,cr,cb