ur,ur,cr,ur,ur,ur,ur,cb,cb,cb,cg,ur,cg,ux,ub,ub,ub,ub,ur,cb,cb,ux,cb
ur,ur,ur,ur,cg,cr,cr,ur,ur,ub,ub,ub,ub,ub,ub,ub,ub,ub,ur,ux,ux,cb,cb
ur,ur,cr,ur,ug,ug,ur,ur,ur,ur,ur,ub,ub,ub,ub,ub,ub,ub,ur,ux,ux,ux,ux
cg,ur,ur,ug,ug,cg,ur,ur,ub,ub,ub,ub,ur,ub,ub,ur,ur,ub,ur,ub,ub,ub,ub
ur,ur,ur,ur,ur,cr,cr,ur,ub,ur,ur,ur,ur,ub,ub,ub,ub,ub,ux,ub,ub,ub,ub
ur,ur,ur,cb,ub,ub,ub,ub,ub,ub,ub,ub,ub,ub,ub,ur,ur,ub,ub,ub,ur,ux,ux
ux,ux,ug,ug,ug,ug,ug,ub,ur,ur,ur,ur,ur,ub,ub,ub,ub,ux,ux,ur,ur,ux,ux
ux,ur,ur,ur,ur,ur,ug,ub,ug,ug,ug,ub,ub,ub,ub,ub,ub,ux,cb,ux,ub,ub,ub
ub,ub,ub,ub,ub,ub,ub,ub,ub,ub,ub,cb,ur,ur,cr,ux,ub,ub,ub,ux,ub,ux,ub
ub,ur,ur,ur,ux,ub,ux,ux,ub,ub,ub,ub,ub,ub,ux,ub,ug,ug,ug,ux,ub,ux,ub
ub,ur,cg,ur,ur,ub,ur,ur,ur,ur,ur,ur,ur,ur,ur,ur,ur,cr,ug,ux,ub,ux,ub
ub,ub,ug,ug,ug,ub,ug,ug,ug,ub,ub,ug,ug,ug,ug,ug,ug,cg,ug,ux,ub,ux,ub
ux,ug,ug,ug,ug,ub,ug,ug,ug,ub,cb,ug,ub,ub,ub,ug,ug,ug,ug,ub,ub,ub,ub
cb,ug,ub,ug,ug,ub,ug,ug,ur,ub,ub,ub,ug,ub,ub,ug,ug,ug,ug,ux,ub,ux,cg
ub,ub,ub,ug,ug,ub,ug,ux,ur,ux,ub,ug,ub,ub,ub,ub,ux,ux,ux,ux,ub,ux,ux
ux,ug,ug,ux,ug,ub,ug,ux,ur,ug,ur,ug,ux,ub,ub,ub,ux,ux,ux,ux,ub,ux,ux
ux,ug,ug,ux,ux,ub,ug,ug,ur,ug,ub,ub,ub,ub,ux,ub,ux,ux,ux,ux,ub,ux,ux
ux,ug,ug,ux,ux,ub,ux,ux,ur,ux,ub,ux,ux,ux,ux,ub,ux,ux,ux,ux,ub,ux,ux
ux,ug,ug,ux,ux,ub,ux,ux,ur,ub,ub,ux,ux,ux,ux,ub,ub,ux,ux,ux,ub,ux,cb
cg,ug,ug,ug,ug,ug,ug,ug,ug,ub,ub,ux,ux,ux,ux,ux,ub,ux,ux,ux,ub,ux,ux
cb,ur,ub,ux,ux,ug,ug,ux,ug,ur,ur,ux,ux,ux,ux,ux,ub,ux,ux,ux,ub,ux,ux
ux,ur,ub,ub,ub,ub,ug,ug,ug,ur,ur,ux,cg,ux,ux,ux,ub,ub,ub,ub,ub,cr,ux
ux,ur,ur,ur,ub,ub,cr,ux,cr,ur,ur,cg,cb,ux,ux,ux,cr,ux,ux,cr,ur,cr,cb