ur,ur,cr,ur,ur,ur,cb,cb,cb,cb,ur,cg,cg,ur,ur,ur,ur,ur,ur,ur,cb,cb,cb
ur,ur,ur,ur,ur,ur,ur,ur,ur,ur,ur,ur,ur,ur,ur,ur,ur,ur,ur,ur,ur,ur,ur
ur,cr,cb,ur,ur,ur,ur,ur,ur,ur,ur,ur,ur,ur,ur,ur,ur,ur,ur,ur,ur,ur,ur
ur,ur,ur,ur,ur,ur,ur,ur,ur,ur,ur,ur,ur,ur,ur,ur,ur,ur,ur,ur,ur,ur,ur
ur,ur,ur,ur,ur,ur,ur,ur,ur,ur,ur,ur,ur,ur,ur,ur,ur,ur,ur,ur,ur,ur,ur
cg,ur,ur,ur,ur,ur,ur,ur,ur,ur,ur,ur,ur,ur,ur,ur,ur,ur,ur,ur,ur,ur,ur
cg,cb,ub,ur,cr,ub,ur,ur,ur,ur,ur,ur,ur,ur,ur,ur,ur,ur,ur,ur,ur,ur,ur
ub,ub,ub,cr,ur,ub,ub,ur,ur,ur,ur,ur,ur,ur,ur,ur,ur,ur,ur,ur,ur,ur,cb
ur,ur,ur,ur,ur,ub,ub,cb,cg,ur,ur,ur,ur,ur,ur,ug,ur,ur,ur,ur,ur,ur,ur
ug,ug,ug,ub,ub,ub,ub,ur,ur,ur,ur,ur,ur,ur,ur,ur,ur,ur,ur,ur,ur,ur,ur
ug,ug,ug,ug,ub,ub,ur,ur,ug,ur,ur,ur,ur,ur,ur,ur,ur,ur,ur,ur,ur,ur,ur
ug,ug,ug,ug,ur,ur,ur,ug,ug,ur,ur,ur,ur,ur,ur,ur,ug,ur,ur,ur,ur,ur,ur
ug,ug,ub,ug,ur,ur,ur,ur,ur,ur,ur,ur,ur,ur,ur,ur,ur,ur,ur,ur,ur,ur,ur
ug,ug,ur,ug,ur,ur,ur,ur,ur,ur,ur,ur,ur,ug,ug,ur,ur,ur,ur,ur,ur,ur,cr
cg,ug,ur,ug,ur,ur,ur,ur,ur,ur,ur,ub,ub,ug,ug,ur,ug,ug,ug,ug,cr,ug,ug
cb,ug,ur,ug,ur,ur,ub,ur,ur,ur,ur,ug,ub,ug,ug,ur,ug,ur,ur,ur,ur,ur,ug
ur,ur,ur,ug,ur,ur,ur,ur,ur,ur,ur,ug,ub,ub,ub,ur,ub,ur,ur,ur,ur,ur,ug
cg,ug,ug,ug,ur,ur,ur,ur,ur,ur,ur,ub,ur,ur,ub,ub,ub,ur,ur,ur,ur,ur,ug
ug,ug,ug,ug,cb,ug,ur,ug,ur,ur,ur,ub,ur,ur,ub,ub,ub,ur,ur,ur,ur,ur,ug
ug,ug,ug,ub,ub,ug,ur,ug,ug,ug,ur,ub,ub,ur,ub,ub,ub,ur,ur,ur,ur,ur,ug
cb,ug,ug,ug,ur,cr,ur,cg,ug,ug,ug,ug,ug,ug,ug,ub,cb,ug,ug,ug,ug,ug,ug
ug,ug,ug,ur,ur,ur,ub,ug,ug,ur,ur,ur,cg,ub,ub,ub,ub,ub,ub,ur,ur,cr,cb
cb,ug,ug,ug,ur,ur,cr,cr,cr,ur,ur,cg,cb,ub,ub,ub,ub,ub,ub,cr,ur,cr,cb