ur,ur,cr,ux,ur,ur,ur,cb,cb,cb,cg,ur,cg,ur,ur,ur,ur,ur,ur,cb,cb,ur,cb
ur,ur,ur,ur,ur,ur,ur,ur,ur,ur,ux,ur,ur,ur,ur,ur,ur,ur,ur,ur,ur,ur,ur
ur,ur,cr,ub,cb,ur,ur,ur,ur,ur,ur,ur,ur,ur,ur,ur,ur,ur,ur,ur,ur,ur,ur
cg,ur,ur,ub,ug,cg,ur,ur,ur,cr,ur,ur,ub,ur,ur,ur,ur,ur,ur,ur,ur,ur,ux
ur,ur,cr,cr,ur,ug,ug,ug,ug,ug,ug,ub,cr,ur,ur,ub,ub,ux,ux,ux,ux,ur,ux
ur,ur,ur,ur,ur,cg,ug,ub,ur,ur,ur,ub,ur,ux,ux,ux,ux,ux,ur,ur,ur,ur,ux
ug,ug,ug,ug,ug,ug,cb,ub,ub,ub,ux,ub,ur,ux,ux,ux,ug,ug,ur,ux,ux,ux,ux
ug,ug,ug,ur,ur,ug,ub,ub,ub,ub,ux,ub,ur,ur,ur,ur,ug,ux,ur,ub,ub,ub,ux
ub,ub,ub,ug,ug,ug,ub,ub,ub,ub,ur,cb,ug,ug,ug,ur,ux,ux,ur,ub,ub,ub,ux
ub,ub,ub,ub,ub,ub,ub,ub,ub,ub,ug,ur,ug,ug,ug,ur,ur,ur,ur,ub,ub,ub,ub
ub,ub,ub,ub,ub,ub,ub,ub,ur,ur,ur,ur,ub,ug,ug,ux,ux,ux,ux,ub,ub,cb,ux
cg,ux,ux,ub,ug,ug,ub,ub,ur,ub,ub,ug,ub,ug,ug,ug,ug,ux,ub,ub,ub,ux,ux
ub,ub,ub,ub,ub,ug,ug,ug,ur,ug,ug,ug,ub,ux,ug,ug,ug,cg,ub,ux,ux,ux,ux
cb,ub,ug,ug,ug,ug,ug,cg,cr,ub,ub,ur,ug,ux,ux,ug,ug,ug,ub,ub,ub,ub,ux
ub,ub,ug,ug,ub,ub,ub,ub,ub,ub,ub,cb,ub,ur,ur,ug,ur,ur,ur,ur,ur,ur,ur
ub,ub,ub,ub,ub,ub,ub,ub,ub,ub,ub,ub,ub,ur,ur,ug,ur,ur,ur,ur,ur,ur,ur
ur,ub,ub,ub,ub,ub,ub,ub,ub,ub,ug,ub,ug,ux,ug,ug,ux,ux,ux,ub,ub,ub,ux
ur,ub,ux,ug,ug,ug,ug,ub,ub,ub,ub,cb,ur,ur,ur,ux,ux,ux,ux,ux,ub,ux,ux
ur,ur,ur,ur,ur,ub,ur,ur,ur,ux,ub,ur,ur,ug,ur,ur,ur,ur,ur,ur,cr,ux,cb
cg,ur,ur,ur,ub,ub,ub,ur,ur,ux,ux,ur,ur,ur,ur,ur,ur,ur,ur,ur,ur,ur,ur
cb,ur,ux,ux,ub,ub,ub,ur,ux,ux,ux,ur,ur,ur,ur,ur,ur,ur,ur,ur,ur,ur,ur
ub,ub,ub,ub,ub,ub,ur,ur,ux,ux,ux,ux,cg,ux,ux,ux,ux,ux,ux,ux,ux,cr,ux
ub,ub,ub,ub,ub,ub,cr,ux,cr,ux,ux,cg,cb,ux,ux,ux,cr,ux,ux,cr,ux,cr,cb