ub,cb,cr,ur,ux,cr,ux,cb,cb,cb,cg,cg,cg,ur,ur,ur,ur,ub,cr,ur,cb,cb,cb
cg,ub,ur,ur,ur,ur,ur,ux,ur,ur,ur,ur,ur,ur,ur,ur,ur,ub,ur,ur,ur,ur,ur
cr,cr,ur,ur,ur,ur,ur,ux,ur,ur,ur,ur,ur,ur,ur,ur,ur,ub,ur,ur,ur,ur,ur
ur,ux,ur,ur,ur,ur,ur,ur,ur,ur,cg,ug,cg,ug,ug,ug,ug,cb,ub,ur,ur,ur,ur
ur,ux,ur,ur,ur,ur,ur,ur,ur,ur,ur,ug,ur,ur,ur,ug,ug,ub,ub,ur,ur,ur,ur
ur,ux,ur,ur,ur,ur,ur,ur,ur,ur,ur,ug,ug,ur,ur,ug,ug,ur,ur,ur,ur,ur,ur
cr,ur,ur,ur,ur,ur,ur,ub,ub,ub,ur,ug,ug,ug,ur,ug,ug,ur,ur,ur,ux,ux,ur
ur,ur,ug,ur,ur,ur,ur,ur,ug,ug,ur,ug,ug,ug,ur,ug,ug,ur,ur,ur,ux,ux,ur
ur,ug,ug,ur,ur,ur,ur,cg,ur,ur,ur,ub,ug,ug,ur,ug,ug,ur,ur,ur,ur,ur,ur
ur,ur,ur,ur,ur,ur,ub,ug,ug,cr,ur,ub,ug,ug,ur,ug,ug,ub,ux,ux,ur,ux,ur
ur,ur,ur,ur,ur,ur,ub,ug,ug,ub,cb,ub,ug,ug,ug,ug,ub,ug,ux,ug,ur,ug,ur
ur,ur,ur,ur,ux,ux,ub,ug,ub,ub,ub,ub,ug,ub,ub,cg,ug,ug,ug,ug,ur,ug,ur
ur,ur,ur,ur,ux,ux,ug,ug,ub,ub,ub,ub,ug,ub,ub,ug,ug,ug,ug,ux,cr,ug,cr
ur,ur,ur,ur,ug,ug,ug,ug,ug,ug,cb,ug,ug,ub,ub,ug,ug,ug,ug,ux,ug,ug,ur
ur,ur,ur,ur,ur,ur,ur,ug,ug,ug,ur,ug,ur,ur,ur,ug,ug,ug,ug,ug,ur,ur,ur
ur,ur,ur,ur,ur,ur,ur,ug,ug,ug,ug,ug,ux,ux,ub,ub,ub,ug,ug,ug,ug,ug,ug
ux,ub,ub,ub,ub,ux,ug,ur,ur,ur,ur,ug,ug,ux,ug,ux,ub,ux,ux,ux,ux,ux,ux
ub,ub,ux,ub,ub,ux,ux,ux,ux,ur,ur,ux,ug,ux,ug,ur,ub,ux,ux,ux,ux,ux,ux
ub,ub,ub,ub,ub,ux,ux,ux,ux,ur,ur,ux,ug,ug,ug,ur,ub,ux,ux,ux,ux,ux,cb
cg,ub,ub,ub,ub,ux,ux,ub,ub,ub,ur,ux,ux,ux,ur,ur,ub,ux,ux,ux,ux,ux,ux
cb,ux,ub,ux,ub,ub,ub,cb,ub,ur,ur,ux,ux,ux,ur,ur,ub,ux,ux,ux,ux,ux,ux
ux,ux,ub,ub,ub,ub,ux,ub,ub,ub,ub,ux,cg,ux,ur,ur,cb,ux,ux,ux,ux,cr,cb
cb,ux,ub,ub,ub,ux,cr,cb,cr,ub,ub,cg,cb,ux,ur,ur,cr,ux,ux,cr,ux,cr,cb