ur,cr,cr,ug,cg,ug,ug,cb,cb,cb,ur,cg,cg,ur,ur,ur,ub,ur,ur,ur,cb,cb,cb
cg,ur,ub,ub,ug,ug,ug,ug,ug,ur,ur,ur,ur,ur,ur,ur,ur,ur,ur,ur,ur,ur,ur
ug,cr,ub,ub,ub,ub,ub,ub,cb,ug,ug,ug,ur,ur,ur,ur,ur,ur,ur,ur,ur,ur,ur
ug,ug,ub,ug,ug,ug,ug,ub,ur,ur,ur,ug,ur,ur,ur,ur,ur,ur,ur,ur,ur,ur,ur
ug,ug,ub,ug,ur,ug,ug,ub,ur,ur,ur,ug,ur,ur,ur,ur,ur,ur,ur,ur,ur,ur,ub
ug,ug,ub,ur,ur,ur,ug,ug,ur,cr,ur,ur,ur,ur,ur,ub,ub,ub,ub,ur,ur,ub,ub
cg,ug,ub,ug,ub,ur,ub,ub,ur,ug,ub,ug,ub,ur,ur,ub,cg,ug,ub,ur,ub,ub,ub
ub,ug,ub,ug,ug,cr,cb,ub,ur,ub,ub,ug,ub,ur,ub,ub,ub,ug,ug,ur,ur,ur,ub
ug,ug,ub,ug,ug,ur,ub,ub,ub,ub,ub,ug,ub,ur,ug,ub,ur,ug,ur,ur,ub,ur,ub
ug,ug,ub,ug,ug,ub,ub,ub,ub,ub,ub,ug,ub,ub,ub,ub,ub,ug,ug,ug,ub,ur,ub
ug,ug,ub,ug,ug,ug,ub,ub,ub,ur,ub,ug,ub,ub,ug,ub,ug,ur,ur,ug,ur,ur,ub
ug,ug,ub,ub,ub,ub,ub,cb,ur,ug,ub,ug,ub,ub,ug,cb,ub,ur,ub,ug,ub,ur,ub
ug,ub,ub,ub,ub,ub,ub,ub,ur,ur,ub,ug,ub,ub,ub,ug,ug,ur,ug,ug,ub,ub,ub
ug,ug,ub,ub,ug,ub,ub,ub,ub,ur,ub,ug,ug,ug,ug,ug,ug,ur,ub,ug,ur,ur,ub
cg,ug,ub,ug,ug,ub,ur,ur,ur,ur,ug,ug,ug,ug,ug,ug,ur,ur,ug,ug,ub,ub,ub
ub,ub,ub,ub,ug,ur,ur,ur,ur,ur,ug,ug,ug,ug,ug,ug,ug,ug,ug,ug,ub,ub,ub
ub,ug,ur,ug,ug,ur,ur,ur,ur,ur,ur,ug,ub,ur,ub,ub,ur,ub,ug,ug,cb,ur,ub
ub,ug,ur,ug,ug,ug,ug,ur,ur,ur,ur,ur,ur,ur,ub,ug,ug,ug,ug,ug,ub,ur,ub
ub,ug,ur,ub,ug,ug,ug,ug,ub,ur,ur,ug,ur,ug,ug,ug,ug,ug,ug,ub,ub,ur,ub
ub,ub,ub,ub,ug,ug,ug,ub,ub,ur,ur,ug,ur,ub,ub,ub,ub,ub,ub,ub,ub,ub,ub
cb,cb,ub,ub,ug,ug,ug,ub,ub,ur,ur,ug,ur,ur,ur,ur,cr,ug,ur,ub,ub,ur,ug
ug,ug,ug,ug,ug,ug,cg,ug,ug,ur,ur,ug,cg,ub,ub,ub,ub,ug,ur,ub,ub,cr,cb
cb,ug,ug,ug,ug,ug,cr,ug,cr,ur,ur,cg,cb,ub,ub,ub,ur,ur,ur,cr,ub,cr,cb