ub,ub,cr,ur,ur,ur,ur,cb,cb,cb,ur,cg,cg,ur,ur,ur,ur,ur,ur,ur,cb,cb,cb
cr,ub,ub,cb,ur,ur,ur,ur,ur,ur,cr,ug,cg,ur,ur,ur,ur,ur,ur,ur,ur,ur,ur
ur,cr,cb,ur,ur,ur,ur,ur,ur,ur,ur,ur,ur,ur,ur,ur,ur,ur,ur,ur,ur,ur,ur
ur,ur,cr,ur,ur,ur,ur,ur,ur,ur,ur,ur,ur,ur,ur,ur,ur,ur,ur,ur,ur,ur,ur
ur,ur,ur,ur,ur,ur,ur,ur,ur,ur,ur,ur,ur,ur,ur,ur,ur,ur,ur,ur,ur,ur,ur
ur,ur,ur,ur,ur,ur,ur,ur,ur,ur,ur,ur,cr,ug,ug,ur,ur,ur,ur,ur,ur,ur,ur
ur,ur,ur,ur,ur,ur,ub,ur,ur,ub,ub,ub,ur,ug,ug,ug,ur,ur,ur,ur,ur,ur,ur
ur,ur,ur,ur,ur,ur,ub,cb,ur,ub,ub,ub,ur,ur,ur,ub,ug,ur,ur,ur,ur,ur,cb
ub,ur,ur,ur,ur,ur,ur,cr,cg,ur,ub,ub,ub,ub,ub,cb,ug,cg,ur,ur,ur,ur,ur
ub,ur,ur,ur,ur,ur,ur,ur,ur,ur,ur,ur,ur,ug,ur,ur,ur,ur,ur,ur,ur,ur,ur
ub,ur,ur,ur,ur,ur,ur,ur,ur,ur,ur,ur,ur,ug,ur,ur,ur,ur,ur,ur,ur,ur,ur
ub,ur,ur,ur,ur,ur,ur,ur,ur,ur,ur,ur,ur,ug,ur,ur,ur,ur,ur,ur,ur,ur,ur
ub,ur,ur,ur,ur,ur,ur,ur,ur,ur,ur,ur,ur,ug,ur,ur,ur,ur,ur,ur,ur,ur,ur
ub,ur,ur,ur,ur,ur,ur,ur,ur,ur,ur,ur,ur,ug,ur,ur,ur,ur,ur,ur,ur,ur,ur
cg,ur,ur,ur,ur,ur,ur,ug,ug,ug,ug,ug,ug,ug,ur,ur,ur,ur,ur,ur,ur,ur,ur
ug,ug,ur,ur,ur,ur,ub,ub,ub,cr,ub,ur,ur,ug,ur,ur,ur,ur,ur,ur,ur,ur,ur
ug,ug,ur,ur,ub,ub,ur,ub,ub,ur,ub,ur,ur,cg,ur,ur,ur,ur,ur,ur,ur,ur,ur
ug,ug,ug,ub,ub,ub,ub,ur,ub,ur,ub,cr,ur,ur,ur,ur,ur,ur,ur,ur,ur,ur,ur
ug,ug,ug,ub,ub,ub,ur,ur,ub,ur,ub,ur,ur,ur,ur,ur,ur,ur,ur,ur,ur,ur,ur
cg,ug,ug,ur,ub,ur,ur,ub,ub,ur,ur,ur,ur,ur,ur,ur,ur,ur,ur,ur,ur,ur,ur
cb,ug,ug,cb,ub,ub,ub,ub,ub,ub,ur,ur,ur,ur,ur,ur,ur,ur,ur,ur,ur,ur,ur
ur,ug,ug,ug,ub,ur,ur,ur,cb,ur,ur,ur,cg,ur,ur,ur,ur,ur,ur,ur,ur,cr,cb
cb,ug,ug,ur,ur,ur,cr,cb,cr,ur,ur,cg,cb,ur,ur,ur,ur,ur,ur,cr,ur,cr,cb