cr,ur,cr,ur,ur,ur,ux,cb,cb,cb,ug,ux,cg,ux,ur,cb,ur,cr,ub,cb,cb,ur,cb
ug,ur,ug,ur,ur,ur,ur,ur,ur,ur,ux,ux,ur,ur,ur,ur,ur,ub,ub,ur,ur,ur,cb
ug,ur,ug,ur,ur,ur,ur,ur,ur,ur,ur,ur,ur,ux,ur,ur,cb,ub,ub,ur,ur,ur,ur
ug,ug,ug,ur,ur,ur,ur,ur,ur,ur,ur,ur,ur,ux,ux,ur,ur,ur,ur,ur,ur,ur,ur
ug,cg,ur,ur,ur,ur,ur,ur,ur,ur,ur,ur,ur,ur,cr,ur,ur,ur,ur,ur,ur,ur,ur
ur,ur,ur,ur,ur,ur,ur,ur,ur,ur,ur,ur,ur,ur,ur,ur,ur,ug,ug,cb,ub,ub,ur
ur,ur,ur,ur,ur,ur,ur,cr,ur,cg,ur,ur,ur,ur,ur,ur,ur,cg,ux,ug,ub,ub,ub
ur,ur,ur,ur,ur,ur,ur,ug,ug,ug,cb,ub,ub,ur,ur,ur,ug,ur,ub,ug,ub,ub,ub
ur,ur,ur,ur,ur,ux,ur,ug,ug,ur,ur,ur,ub,ur,ur,ur,ur,ur,ub,ub,ur,ub,ub
ur,ur,ur,ur,ur,ur,ur,ur,ug,ug,ug,ur,ub,ur,ur,ur,ur,ur,ub,ub,ub,ub,ub
ur,ur,ur,ur,ur,ur,ur,ur,ug,ur,ug,ub,ub,ur,ur,ur,ur,ug,ug,ub,ub,ub,ub
ur,ur,ur,ur,ur,ur,ur,cr,ug,ug,ug,cg,ub,ug,ub,ub,ub,ug,ug,ub,ub,ub,ub
ur,ur,ur,ur,ur,ub,ub,ub,ub,ug,ug,ug,ub,ub,ub,ux,ub,ux,ug,ur,ub,ur,ur
ur,ur,ur,ur,ur,ur,ur,ub,ux,ug,ug,ug,ub,ub,ub,ux,ub,ux,ug,ux,ub,ub,cg
ux,cr,ux,ur,ub,ub,ub,ub,ug,ug,ub,ug,ug,ug,ub,ug,ub,ux,ug,ux,ub,ub,ub
ux,ur,ur,ur,ub,ub,ux,ux,ux,ug,ug,ub,ug,ug,ub,ug,ub,ub,ug,ub,ub,ub,ub
ux,ux,ux,ub,ub,ub,ub,ub,ub,ub,ub,ub,ub,ub,ub,ug,ug,ug,ug,ub,cb,ub,ub
ux,ux,ux,ub,ub,ub,ub,ub,ub,cb,ux,ux,ug,ug,ux,ux,ug,ug,ug,ub,ub,ub,ub
cg,ux,ux,ub,ub,ub,ub,ub,ub,ub,ub,ub,ug,ug,ug,ug,ug,ub,ur,ur,ur,ur,ur
cg,ur,ur,ur,ur,ur,ur,ur,ur,ur,ur,ur,ug,ug,ug,ug,ur,ur,ur,ur,ur,ur,ur
cb,ur,ux,ux,ux,ux,ux,ux,ux,ux,ux,ur,ur,ur,ur,ur,ur,ur,ur,ur,ur,ur,ur
ux,ur,ux,ux,ux,ux,ux,ux,ux,ux,ux,ux,cg,ux,ux,ux,ux,ux,ux,ux,ux,cr,ur
ux,cr,ux,ux,ux,ux,cr,ux,cr,ux,ux,cg,cb,ux,ux,ux,cr,ux,ux,cr,ux,cr,cb