ur,ur,cr,ur,ur,ur,ur,cb,cb,cb,cg,cg,cg,cb,ur,ur,ur,ur,ur,ur,cb,cb,cb
ur,ur,ur,cg,ug,ur,ur,cg,ur,ur,ur,ur,ur,ur,ur,ux,ux,ux,ur,ur,ur,ur,ur
cr,cr,ur,ug,ug,cr,ur,ug,ur,ur,ur,ur,ur,ur,ur,ur,ur,ux,ux,ux,ur,ux,ur
cb,ur,ur,ur,ur,ug,ug,ug,ug,ur,ur,ur,ur,ur,ur,ur,ur,ur,ur,ur,ur,ux,ur
ur,ur,ur,ug,ug,ug,ug,ug,ug,ur,ur,ur,ur,ur,ur,ux,ux,ux,ux,ur,cb,ux,ur
ur,ur,ur,cg,ug,ug,ug,cg,ur,ur,ur,ur,ur,ur,ur,ur,ux,ux,ub,ub,ub,ub,ur
ur,ur,ur,ur,cr,ug,ug,ur,ur,ur,ur,ur,ur,ur,ur,ur,ux,ub,ub,ur,ur,ur,ur
ur,ur,ur,ur,ur,ug,ug,ug,ur,ur,ur,ur,ur,cr,ux,ux,ux,ur,ur,ur,ub,ur,ur
ur,ur,ur,ur,ur,ug,ug,ug,ur,ur,ur,cr,ur,ur,ur,ux,ur,ur,ur,ur,ub,cr,ub
ur,ur,ur,ur,ur,ug,ug,cb,ub,ur,ur,ur,ur,ur,ur,ux,ur,ur,ur,ur,ub,ub,cr
ur,ur,ur,ur,ur,ur,ub,ub,ub,ur,ur,ur,ur,ur,ug,ug,ug,ug,ug,ur,ub,ub,ur
ur,ur,ur,ur,ur,ur,ub,ub,ub,ub,ub,ub,ub,ub,ug,ug,ug,ug,ug,ur,ux,ub,ur
ur,ur,ur,ur,ur,ur,ur,ur,ug,ub,ub,ub,ub,ub,ug,ug,ug,ur,ug,ur,ux,ux,ur
ur,ur,ur,ur,ur,ur,ur,ur,ug,ug,cb,ub,ub,ub,ug,ur,ug,cg,ux,ur,ux,ux,ur
ur,ur,ux,ux,ur,ur,ub,ug,ug,ug,ug,ub,ub,ub,ug,ug,ug,ur,ur,ur,ux,ux,ur
ux,ux,ux,ux,ur,ur,ux,ug,ux,ug,ug,ug,ur,ux,ux,ux,ux,ux,ux,ux,ux,ux,ur
ux,ux,ux,ux,ur,ur,ur,ug,ux,ug,ug,ug,ur,ux,ux,ux,ux,ux,ux,ux,ux,ux,ur
ux,ug,ug,ug,ur,ur,ur,ug,ug,ug,ug,ug,ur,ur,ur,ur,ur,ur,ur,ur,ur,ur,ur
ux,ux,ux,ux,ux,ux,ux,ux,ux,ux,ug,ug,ur,ur,ux,ux,ux,ux,ux,ux,ux,ux,cb
cg,ux,ux,ux,ux,ux,ux,ux,ux,ux,ux,ux,ur,ur,ur,ur,ur,ur,ur,ur,ur,ur,ur
cb,ux,ux,ux,ux,ux,ux,ux,ux,ux,ux,ux,ur,ur,ur,ur,ur,ur,ur,ur,ur,ur,ur
ux,ux,ux,ux,ux,ux,ux,ux,ux,ux,ux,ux,cg,ux,ux,ux,cb,ux,ux,ux,ux,cr,cb
cb,ux,ux,ux,ux,ux,cr,cb,cr,ux,ux,cg,cb,ux,ux,ux,cr,ux,ux,cr,ux,cr,cb