ur,ur,cr,ur,ur,ur,ur,cb,cb,cb,ur,cg,cg,ur,ur,ur,ur,ux,cr,ux,cb,cb,cb
ur,ur,ur,ur,ur,ur,ur,ur,ur,ur,ur,ur,cb,ur,ur,ur,ur,ux,ur,ux,ux,ux,ux
ur,cr,ur,ur,ur,ur,ur,ux,ur,ur,ur,ur,ur,ur,ur,ur,ur,ur,ur,ux,ux,ux,ux
ur,ur,ur,ur,cr,ux,ux,ux,ug,cr,ur,ur,ur,ur,ur,ug,ug,ug,ur,ux,ux,ux,ux
ux,ur,ur,ur,ur,ur,ur,ur,ug,cr,ur,ur,ur,ur,ur,ur,ur,ux,ur,cr,ug,ux,ux
ub,ub,ub,ux,ug,cg,ur,ur,ub,ur,ug,ug,cg,ur,ur,ur,ur,ux,ur,ur,ug,ux,ux
ux,ub,ub,ux,ug,ur,ur,ur,ur,ur,ur,ur,ur,ur,ur,ur,ur,ur,ur,ur,ub,ub,ux
cg,cb,ub,ub,ug,ug,ur,ub,ub,ur,ur,ur,cb,ub,ub,ur,ur,ur,ur,ur,ub,ub,ub
ug,ub,ub,ub,ub,ug,cb,ub,ub,ur,ur,ux,ub,ub,ub,ur,ur,ur,ur,ur,ur,ur,cr
ug,ux,ub,ux,ux,ug,ug,ub,ux,ur,cg,ug,ub,ur,ur,ur,ur,ur,cr,ux,ux,ub,ub
ug,ux,ux,ux,ug,ug,ug,ug,ub,ub,ub,ub,cb,ug,ux,ux,ux,ub,ux,ux,ub,ub,ub
ug,ux,ux,ux,ug,ug,ux,ux,ux,ur,ug,ug,ug,ug,ux,ux,ux,ub,cb,ub,ub,ux,ub
ug,ux,ux,ux,ug,ug,ux,ux,ux,ug,ug,ux,ux,ur,ux,ux,ux,ux,ux,ux,ux,ub,ub
ug,ux,ux,ux,ug,ug,ux,ux,ug,ug,ub,ug,ug,ur,ug,ug,ug,ug,ug,ux,ux,ub,ub
ug,ux,ux,ux,ux,ux,ux,ux,ug,cb,ub,ub,ub,ub,ux,ux,ux,ux,ug,ux,ux,ux,ux
ug,ug,ug,ug,ug,ub,ub,ub,ug,ur,ug,ux,ux,ub,ux,ux,ux,ux,ux,ux,ux,ux,ux
ux,ux,ug,ux,ug,ub,ub,ub,ug,ug,ug,ub,ub,ub,ux,ux,ux,ux,ux,ux,ux,ux,ux
ux,ux,ug,ux,ug,ub,ub,ub,ub,ub,ub,ub,ub,ub,ux,ux,ux,ux,ux,ux,ux,ux,cg
ux,ux,ug,ux,ug,ux,ub,ub,ub,ub,ub,ub,ux,ur,ux,ux,ux,ux,ux,ux,ux,ux,cb
cg,ux,ug,ux,ug,ug,ug,ug,ug,ug,ug,ug,ug,ur,ug,ug,ug,ux,ux,ux,ux,ux,ux
cb,ux,ug,ux,cg,ug,ux,ux,ux,ur,ux,ux,ux,ur,ux,ug,ug,ur,ux,ux,ux,ux,ux
ug,ug,ug,ug,ug,ug,ug,ux,ux,ur,ux,ux,cg,ur,ux,ux,ux,ur,ux,ux,ux,cr,cb
cb,ux,ug,ux,ug,ug,cr,cb,cr,ux,ux,cg,cb,ur,ur,ur,ur,ur,ux,cr,ux,cr,cb