ur,ur,cr,cb,ub,ur,ur,cb,cb,cb,ur,cg,cg,ug,ug,ug,ug,ur,ur,ur,cb,cb,cb
ur,ur,ur,ub,ub,ur,ur,ur,ur,cr,cr,ur,ur,ug,ug,ub,ug,ub,ub,ub,ub,ub,ub
ur,cr,ub,ub,ur,ur,ur,ur,ub,ur,ur,ur,ur,ug,cg,ub,ug,ub,ub,ub,ub,ub,ub
ub,ur,ub,ur,ur,ur,ur,ub,ur,ur,ub,ub,ur,ur,ur,ur,ug,ur,ur,ur,ur,ur,ub
ub,ur,ur,ur,ur,ur,ur,ur,ur,ur,ub,ur,ur,ub,ug,ug,ug,ug,ug,ur,ur,ur,ub
cg,ur,ur,ur,ur,ur,ur,ur,ur,ur,ub,ur,ug,ub,ug,ug,ug,ug,ug,ur,ur,ub,ub
cg,ur,ur,ug,ur,ur,ub,ug,ug,ur,ub,ur,ur,ub,ur,ug,ug,ug,ub,ur,ur,ur,ub
ur,ur,ur,ug,ur,ur,ub,cb,cb,ub,ub,ur,ur,ub,ub,ug,ug,ug,ug,ur,ur,ur,ub
ur,ur,ur,ug,ug,ug,ub,ub,ur,ur,ub,ur,ur,ub,ug,ug,ug,ug,ur,ur,ub,ur,ub
cg,ug,ur,ug,ug,ug,ub,ub,ub,ub,ub,ug,ub,ub,ur,ur,ug,ub,ug,ug,ub,ur,ub
ug,ug,ur,ur,ug,ug,ur,ur,ug,ur,ug,ug,ug,ub,ur,ug,ug,ub,ur,ug,ur,ur,ub
ug,ug,ug,cr,ug,ug,ub,ub,ug,ur,ug,ug,ug,ub,ur,ur,ug,ub,ub,ug,ub,ur,ub
ug,ug,ug,ug,ug,ug,ub,ub,ug,ur,ug,ur,ug,ug,ug,ub,ug,ub,ug,ug,ub,ub,ub
ug,ug,ug,ug,ug,ug,ub,ub,ug,ug,ug,ug,ug,ur,ug,ur,ub,ub,ub,ur,ub,ur,ub
cg,ub,ub,ub,ub,ub,ub,ub,ub,ub,ug,ub,ub,ub,ub,ur,ur,ur,ur,ur,ur,ur,ur
cb,ub,ug,ug,ug,ug,ug,ug,ug,ug,ug,ug,ug,ug,ug,ur,ug,ub,ub,ub,ub,ub,ur
ug,ub,ug,ug,ug,ug,ug,ug,ug,ug,ug,ug,ug,ug,ug,ug,ug,cg,ur,ub,ur,ub,ur
ug,ub,ug,ug,ug,ug,ug,ug,ug,ug,ug,ug,ug,ug,ug,ur,ur,ub,ub,ub,ub,ub,ur
ug,ub,ug,ug,ug,ug,ug,ug,ug,ug,ur,ug,ur,ug,ug,ur,ur,ub,ub,ub,ub,ur,cr
cb,ub,ug,ug,ug,ug,ug,ug,ub,ug,ug,ug,ug,ug,ug,ur,ur,cb,ub,ub,ub,ub,ub
cb,cb,ug,ug,ug,ug,ug,ug,ub,ur,ur,ug,ur,ur,ur,ur,ur,ur,ur,ur,ur,ur,ur
ug,ug,ug,ug,ug,ug,ug,ug,ug,ur,ur,ug,cg,ur,ur,ur,ur,ur,ur,ub,ub,cr,cb
cb,ug,ug,ug,ug,ug,cr,ug,cr,ur,ur,cg,cb,ur,ur,ur,ur,ur,ur,cr,ub,cr,cb