cr,ux,cr,ur,ur,ub,cb,cb,cb,cb,cg,cg,cg,ur,ur,cr,ux,ux,ux,ux,cb,cb,cb
cg,ux,ux,ur,ur,ur,cr,ur,ur,ur,ur,ux,ux,ur,ux,ux,ur,ux,ux,ux,ux,ux,ux
ur,cr,ur,ur,ur,ur,ur,ur,ur,ur,ur,ur,ux,ur,ur,ux,ur,ur,ur,ur,ur,ur,ux
ur,ur,ur,ur,ur,ur,ur,ur,ur,ur,ur,ur,ux,ux,ur,ur,ur,ur,ur,ur,ur,ux,ux
ur,ur,ur,ur,ur,ur,cr,ur,cr,ux,ux,ur,ux,ux,ux,ux,ux,ur,ur,ur,ur,ur,ur
ur,ur,ur,ur,ur,ug,ug,ug,ug,ux,ux,ur,ur,ur,ur,ur,ux,ux,ux,ux,ur,ux,ur
ur,ur,ur,ux,ug,ur,ug,ux,ug,ux,ux,ux,ux,ux,ux,ur,ux,ux,ux,ux,ur,ux,ur
ur,ur,ur,ux,ug,ur,ug,ug,ug,ux,ux,ux,ux,ux,ux,ux,ux,ub,ub,ux,ur,ux,ur
ur,ur,ur,ug,ug,ur,ug,ug,ug,ug,ug,ug,ug,ug,ug,ug,ug,ug,ug,ub,ub,ub,ub
cr,ur,ur,ug,ug,ur,ug,ug,cg,ug,ug,ug,ug,ug,ux,ux,ux,ub,cb,ub,ub,ub,ub
ur,ur,ur,ug,ug,ur,cg,ug,ug,ub,ug,ug,ug,ug,ux,ux,cg,ug,ub,ub,ub,ux,ub
ur,ux,ur,ug,ug,ur,ux,ug,ug,ub,ub,ub,ug,ux,ux,ux,ux,ub,ub,ux,ub,ux,ub
ur,ux,ur,ug,ug,ur,ux,ux,ux,cb,ug,ub,ug,ux,ux,ux,ux,ux,ub,ux,ub,ux,ub
ur,ur,ur,ug,ug,ur,ux,ux,ux,ug,cb,ub,ub,ux,ux,ux,ux,ux,ub,ub,ub,ux,ub
ux,ux,ur,ug,ug,ur,ux,ux,ux,ug,ux,ug,ub,ux,ux,ux,ux,ub,ub,ub,ub,ux,ub
ux,ux,ur,cg,ug,ur,ux,ux,ux,ug,ug,ug,ub,ub,ub,ub,ub,ub,ub,ub,ub,ux,cb
ub,ub,ux,ux,ug,ur,ux,ux,ux,ux,ux,ux,ux,ux,ux,ub,ux,ub,ub,ux,ub,ux,ur
ub,ub,ux,ux,ug,ur,ug,ug,ug,ug,ug,ug,ug,ug,ug,ub,ub,ub,ux,ux,ub,cr,ur
ub,ub,ub,cb,ux,ur,ux,ux,ux,ux,ux,ux,ux,ux,ux,ux,ux,ux,ux,ux,ub,ux,cb
cg,ub,ub,ub,ux,ur,ux,ux,ux,ux,ux,ux,ux,ux,ux,ux,ux,ux,ux,ub,ub,ub,ub
cb,ub,ub,ub,ux,ur,ux,ux,ux,ux,ux,ux,ux,ux,ux,ux,ux,ux,ux,ub,ub,ub,ux
ub,ub,ub,ub,ub,ur,ub,ux,ux,ux,ux,ux,cg,ux,ux,ux,ux,ux,ub,ub,ub,cr,cb
cb,ub,ub,ub,ub,cr,cr,cb,cr,ux,ux,cg,cb,ux,ux,ux,ux,ux,ux,cr,ub,cr,cb