ug,ug,cr,ur,cg,ug,ug,cb,cb,cb,ux,cg,cg,ur,ux,ux,ub,ub,ub,ub,cb,cb,cb
ug,ug,ur,ur,ur,ur,ug,ur,ur,ux,ux,ux,ur,ur,ur,ur,ub,ur,ur,ub,ub,ur,cb
ug,cr,ur,ur,ur,ur,ug,ur,ur,ur,ur,ur,ur,ur,ur,ur,ur,ur,ur,ur,ub,ux,ux
ug,ug,ug,ug,ug,ug,cr,ur,ug,ur,ur,ur,ur,ur,ur,ur,ug,ub,ub,ur,ub,ub,ux
ur,ur,ur,ur,ur,ur,ur,ug,cr,ur,ux,ur,ur,ur,ur,ur,cr,ub,ug,cb,ub,ux,ux
cb,ur,ur,ur,ur,ur,ur,ur,ur,ur,ux,ux,ux,ux,ub,ub,ub,ug,ug,ux,ug,ux,ux
ur,ur,ur,ur,ur,ur,ur,ug,ur,cb,ub,ub,ub,ux,ub,ug,ug,ug,ux,ux,ug,ux,ux
ur,ur,ur,ur,ur,cr,ux,ug,ub,cb,ux,ub,ub,ux,ub,ug,ug,ug,ux,ux,ug,ux,ux
ux,ux,ux,ux,ux,ux,ub,ug,ub,ub,ub,ub,ub,ub,ub,ug,ux,ux,ux,ux,ug,ux,ux
ux,ux,ux,ux,ux,ux,ux,cg,ug,ug,cg,ub,ub,ub,ub,ug,ur,ur,ux,ux,ug,ux,ux
ux,ux,ux,ux,ux,ux,ux,ug,ub,ub,ub,ub,ub,ub,ux,ug,ux,ux,ux,ux,ug,ux,ux
ux,ux,ux,ux,ux,ux,ux,ug,ug,ug,ug,ug,ug,ug,ug,ug,ux,ux,ux,ux,ug,ux,ux
ub,ux,ux,ux,ux,ux,ur,ur,ur,ub,ub,ub,ub,cb,ub,ub,ux,ux,ux,ux,ug,ug,ug
ub,ub,ux,ux,ux,ux,ur,ux,ux,ub,ub,ub,ux,ub,ux,ux,ux,ux,ux,ux,ur,ux,ug
ub,ux,ux,ux,ux,ux,ur,ux,ux,ub,ub,ub,ux,ub,ux,ux,ux,ux,ug,ug,ur,ux,ug
ub,ub,cb,ux,ux,ux,ur,ux,ux,ub,ub,ub,ub,ub,ug,ug,ug,ug,ug,ug,ur,ux,ug
ux,ub,ub,ux,ux,ux,ur,ux,ux,ux,ux,ux,ux,ux,ug,ux,ug,ug,ug,ug,ur,ux,ug
ux,ux,ux,ux,ur,ur,ur,ux,ux,ux,ux,ux,ux,ux,ug,ug,ug,ug,ug,ug,ur,ux,cg
ux,ux,ur,ur,ur,ux,ux,ux,ux,ux,ux,ux,ux,ux,ux,ux,ug,ub,ux,cg,ur,ub,ux
cg,ux,ur,ux,ux,ux,ux,ux,ux,ux,ux,ux,ux,ux,ux,ux,cb,ub,ub,ub,ur,ub,ux
cb,ux,ur,ur,ur,ur,cr,ux,ux,ux,ux,ux,ux,ux,ux,ub,ub,ug,ub,ub,ur,ub,ux
ux,ux,ux,ux,ux,ux,ux,ux,ux,ux,ux,ux,cg,ux,ux,ux,ub,ux,ux,ub,cr,cr,cb
cb,ux,cg,ux,ux,ux,cr,cb,cr,ux,ux,cg,cb,ux,ux,ux,ux,ux,ux,cr,ur,cr,cb