ur,ur,cr,cb,ur,ur,ub,cb,cb,cb,ur,cg,cg,ur,ur,ur,ur,ur,ur,ur,cb,cb,cb
ur,ur,ur,ur,ur,ur,ur,ur,cb,ur,ur,ur,ur,ur,ur,ur,ur,ur,ur,ur,ur,ur,ur
ur,cr,cb,ur,ur,ur,ur,ur,ur,ur,ur,ur,ur,ur,ur,ur,ur,ur,ur,ur,ur,ur,ur
ur,ur,ur,ur,ur,ur,ur,ur,ur,ur,ur,ur,ur,ur,ur,ur,ur,ur,ur,ur,ur,ur,ug
ur,ur,ur,ur,ur,ur,ur,ur,ur,ur,ur,ur,ur,ur,ur,ur,ur,ur,ug,ur,ur,ur,ug
cg,ur,ur,ur,ur,ur,ug,cr,ug,ur,ur,ur,ur,ur,ug,ub,cr,cr,ur,ur,ur,ub,ug
cg,ur,ur,ur,ur,ur,ug,ur,cg,ur,ug,ur,ur,ur,ur,ub,ug,ug,ub,ur,ug,ur,ug
ur,ur,ur,ur,ur,ub,ug,ug,ur,ur,ub,ub,ub,ur,ub,ub,ug,ug,ug,ur,ug,ur,ug
ur,ur,ur,ug,ur,ub,ub,ub,ub,ub,ur,ug,ug,ur,ur,ug,ug,ug,ur,ur,ug,ur,ug
ug,ug,ug,ug,ur,ub,ub,ur,ur,ub,ur,ur,ur,ur,ur,ur,ug,ug,ur,ur,ur,ur,ug
ug,ug,ug,ug,ub,ub,ub,ur,ug,ub,ur,ub,ub,ub,ur,ug,ug,ug,ur,ur,ur,ur,ug
ub,ub,ub,ub,ub,ub,ub,ur,ur,ub,ur,ub,ub,ur,ur,ur,ug,ug,ur,ur,ur,ur,ug
cb,ub,cg,ug,ub,ub,ug,ug,ur,ug,ur,ur,ub,ug,ug,ug,ur,ug,ur,ur,ur,ur,ur
ug,cb,ug,ug,ug,ub,ug,ug,ur,ug,ur,ur,ub,ug,ug,ug,ur,ug,ur,ur,ur,ur,ur
cg,ug,cg,ug,ug,ub,ub,ub,ur,ur,ub,ub,ub,ub,ug,ug,ur,ug,ur,ur,ur,ur,ur
cb,ug,ug,ug,ug,ug,ug,ug,ug,ur,ub,ug,ug,ug,ug,ug,ug,ug,ur,ur,ur,ur,ur
ug,ug,ug,ug,ug,ug,ug,ub,ub,ub,ub,ug,ug,ug,ug,ug,ub,ug,ur,ur,ur,ur,ur
ug,ug,ug,ug,ur,ur,ur,ur,ur,ur,ub,ub,cb,ug,ug,ub,ub,ug,ur,ur,ur,ur,ur
ug,ug,ug,ug,ur,ug,ub,ug,ur,ur,ub,ub,ur,ub,ub,ub,ub,ug,ur,ur,ur,ur,ur
ug,ug,ug,ug,ur,ug,ub,ug,ug,ug,ug,ub,ub,ub,ub,ur,ur,ur,ur,ur,ur,ur,ur
cb,cb,ug,cr,ur,ug,ub,ur,ur,ur,ub,ub,ub,ub,ur,ur,ur,ur,ur,ur,ur,ur,ur
ub,ur,ur,ur,ur,ug,ub,ur,ur,ur,ub,ur,cg,ur,ur,ur,ur,ur,ur,ur,ur,cr,cb
cb,ur,ur,ur,ur,ug,cr,cr,cr,ur,ub,cg,cb,ur,ur,ur,ur,ur,ur,cr,ur,cr,cb