cr,ur,cr,ub,ub,ur,ur,cb,cb,cb,cg,cg,cg,ur,ur,ux,ux,ur,ur,ur,cb,cb,cb
cg,ur,ur,ur,ub,ub,cb,cr,ur,cb,ub,ux,ux,ur,ur,ur,ur,ur,ux,ur,ux,ux,ux
ur,cr,ur,ur,ur,ub,ur,ub,ub,ub,ub,ux,cr,ur,ur,ur,ur,ur,ux,ur,ux,ux,ux
ur,ur,ur,ur,cr,ux,ur,ur,ux,ux,ub,ub,ub,ur,ur,ux,ux,ur,ur,ur,ux,ux,ux
ur,cr,ur,ur,ur,ur,ur,ur,ux,ux,ux,cr,ub,ub,ux,ug,ug,ux,ur,ur,ux,ux,ux
ur,ur,ur,ur,ur,ux,ux,ux,ur,ux,ux,ur,ub,ub,ub,ug,ug,ug,ug,ur,ux,ux,ux
ur,ur,ur,ur,ur,ur,ur,ur,ur,ur,ur,ur,ux,ux,ux,ug,cg,ux,ux,ux,ux,ux,ux
ur,ur,ur,ur,ur,ur,ur,ur,ur,ur,ur,ur,ux,ux,ux,ug,ug,ux,ux,cr,ux,ux,ux
ux,ux,ur,ur,ur,ur,ur,ur,ur,ur,ur,ux,ux,ug,ug,ug,ux,ux,ux,ur,ug,ug,ux
ux,ux,ub,ux,ux,ux,ux,ug,ux,ux,ux,ux,ux,ug,ug,ug,ug,ug,ug,ur,ug,ug,ux
ux,ux,ub,ux,ux,ux,ux,ug,ux,ub,ub,ub,ub,cb,ug,ug,ug,ux,ug,ur,ug,ug,ux
ux,ux,ub,ux,ug,ug,ug,ug,cg,ub,ub,ub,ub,ux,ug,ug,cg,ux,ug,ur,ug,ug,ux
ub,ub,ub,ub,ub,ub,cb,ub,ug,ub,ub,ub,cg,ug,ug,ug,ug,ug,ug,ur,ux,ux,ux
ux,ux,ux,ux,ux,ub,ub,ub,ug,ub,cb,ux,ug,ug,ux,ux,ux,ub,ub,ub,ux,ux,ux
ux,ux,ux,ux,ux,ub,ub,ub,ug,ub,ug,ug,ug,ug,ux,ux,cb,ub,ux,ub,ux,ux,ux
ux,ux,ux,ux,ug,ug,ug,ug,ug,ux,ug,ux,ub,ug,ub,ub,ub,ub,ub,ub,ub,ub,ub
ur,ux,ux,ux,ug,ug,ux,ux,ux,ux,ug,ug,ug,ug,ux,ux,ux,ux,ux,ub,ub,ux,ub
ur,ur,ur,ur,ur,ug,ur,ur,ur,ur,ug,ug,ur,ur,ur,ur,ur,ur,ur,ur,ub,ub,ub
ux,ux,ux,ux,ux,ug,ug,ug,ug,ug,ug,ug,ug,ug,ug,ug,ux,ux,ux,ug,ux,ux,cb
cg,ux,ux,ux,ur,ur,ur,ur,ur,ur,ur,ux,ux,ux,ux,ug,ug,ug,ug,ug,ux,ux,cr
cb,ux,ux,ux,ur,ur,ur,ur,ur,ur,ur,ur,ur,ur,ur,ur,ur,ur,ur,ur,ur,ur,ur
ux,ux,ux,ux,ur,ur,ux,ux,ux,ux,ux,ux,cg,ux,ux,ux,ux,ux,ux,ux,ux,cr,cb
cb,ux,ux,ux,ur,ur,cr,cb,cr,ux,ux,cg,cb,ux,ux,ux,ux,ux,ux,cr,ux,cr,cb