ug,ug,cr,cb,ur,ur,ur,cb,cb,cb,cg,ur,cg,ur,ur,ur,ur,ur,ur,cb,cb,ur,cb
ug,ug,ug,ug,cg,ur,ur,ur,ur,ur,ur,ur,ux,ur,ur,ur,ur,ur,ur,ur,ur,ur,ur
ug,ug,ug,ug,ub,cr,ur,ur,ur,ur,ur,ur,ux,ux,ur,ur,ur,ur,ur,ur,ur,ur,ur
ur,ur,ur,cg,ug,ur,ur,cr,ur,ur,ur,ux,ux,ur,ur,ur,ur,ur,ur,ur,ur,ur,ur
ur,ur,ur,ur,cr,ub,ub,cb,ub,cb,ur,ux,ux,ur,ur,ur,ur,ur,ur,ur,ur,ur,ur
ur,ur,ur,ur,ur,ug,cg,ub,ub,ub,ur,ur,ur,ur,ur,ur,ur,ur,ur,ur,ur,ur,ur
ub,ur,ur,ug,ug,ug,ug,ub,ub,ub,ur,ur,ur,ur,ur,ur,ur,ur,ur,ur,ur,ur,ur
ux,cr,ug,ug,ug,ug,ug,ub,ub,ub,ur,ur,ur,ur,ur,ur,ur,ur,ur,ur,ur,ur,ur
ug,ur,ur,ur,ug,ub,ub,ub,ub,ub,ur,ur,ur,ub,ur,ur,ur,ur,ur,ur,ur,ur,ur
ug,ur,ug,ur,ug,ub,ug,ug,ux,ub,ux,ub,ub,ub,ub,ur,ur,ur,ux,ur,ur,ur,ur
ug,ur,ug,ur,ub,ub,ux,ug,ux,ub,ub,ub,ub,ub,ub,ug,ug,ug,ur,ur,ur,ur,ur
cg,ur,ug,ur,ub,ub,ug,ug,ug,ug,ug,ub,ub,ub,cb,ub,ur,cg,ur,ur,ur,ur,ur
ux,ur,ux,ur,ug,ub,ug,ug,ux,ux,ug,ux,ub,cb,ub,ub,ur,ur,ur,ur,ur,ur,ur
ur,ur,ug,cr,ug,ub,ub,ub,ub,ub,ub,ub,ub,ub,ub,ub,cb,ur,ur,ur,ux,ur,ur
ur,ur,ug,ug,ug,ug,ux,ug,ub,ug,ug,ug,ub,ub,ug,ur,ur,ub,ux,ub,ub,ur,ur
ur,ur,ur,ur,ur,ur,ur,ur,ub,ub,ub,ub,ub,ub,ub,ur,cr,ub,ub,ub,ub,ub,ur
ur,ux,ux,ux,ux,ux,ux,ub,ub,ub,ug,ub,ub,ub,ub,ur,ub,ub,ub,ux,ur,ub,ur
ur,ux,ux,ux,ux,ux,ux,ub,ug,ug,ug,ub,ux,ux,ub,ur,ub,ub,ub,ux,ub,ub,ur
ur,ur,ur,ur,ur,ub,ub,ub,ug,ug,ub,ub,ub,ub,ub,ur,ub,ub,ub,ub,ub,ux,cb
cg,ux,ux,ux,ux,ub,ux,ux,ux,ub,ux,ux,ux,ux,ux,cr,ux,ux,ub,ub,ux,ux,ux
cb,ux,ux,ux,ub,ub,ux,ux,ux,ub,ux,ux,ux,ux,ux,ux,ux,ux,ux,ux,ux,ux,ux
ux,ux,ub,ub,ub,ub,ub,ub,ub,ub,ux,ux,cg,ux,ux,ux,ux,ux,ux,ux,ux,cr,ub
ux,ux,ub,ub,ub,ub,cr,ux,cr,ub,cb,cg,cb,ux,ux,ux,cr,ux,ux,cr,ux,cr,cb