ug,ur,cr,ug,ug,ug,ur,cb,cb,cb,ub,cg,cg,ur,ur,ur,ur,ub,ub,ub,cb,cb,cb
ug,cr,ug,ug,ug,ug,ug,ug,ug,ug,ug,ug,ug,ug,ug,ub,ub,ub,ub,ub,ub,ub,ug
ug,ug,ug,ug,ug,ug,ug,ug,ug,ug,ug,ug,ug,ug,ub,cb,ub,ub,ug,cr,ur,ur,ug
ug,ug,ug,ug,ug,ug,ug,ub,ug,ug,ug,ug,ub,ub,ub,ub,ub,ub,ub,ub,ub,ur,ug
ug,ug,ug,ub,ub,ub,ug,ub,ub,ub,ub,ub,ug,ur,ur,ur,ur,ur,ur,ur,ur,ur,ug
ug,ug,ug,ug,ug,ug,ug,ug,ug,ug,ug,ug,cb,ub,ug,cg,ub,ub,ub,ub,ub,ur,cr
cg,ug,ug,ub,ub,ur,ub,ur,ur,ur,ur,ub,ub,ub,ur,ur,ur,ur,ur,ur,ur,ur,ur
ub,ug,ug,ur,ug,ur,ub,ur,ub,ub,ub,ub,ub,ub,ub,ub,ub,ub,ug,ug,ub,ur,ur
ug,ug,ug,ub,ug,ur,ur,ur,ub,ub,ub,ub,ub,cb,ub,ub,ur,ur,ur,ug,ub,ur,ur
cb,ug,ug,ur,ur,ur,ub,ur,ub,ub,ub,ub,ub,ub,ub,ub,ub,ub,ub,ug,ub,ub,ur
ub,ub,ub,ur,ug,ub,ub,ur,ub,ub,ub,ub,ub,ub,ub,ub,ug,ug,ub,ug,ub,ub,ur
ub,ub,ug,ur,ug,ub,ub,ur,ub,ur,ub,ub,ub,ub,ub,ub,ub,ub,ub,ug,ub,ur,ur
ub,ub,ur,ur,ug,ur,ub,ub,ur,ur,ur,ub,cb,ug,ug,ug,ug,ug,ug,ug,ub,ub,ub
ug,ug,ug,ug,ug,ur,ub,ub,ub,ub,ub,ub,ub,ug,ug,ub,ug,ug,ub,ur,ur,ur,ub
cg,ug,ug,ug,ug,ug,ub,ub,ub,ub,ub,ub,ug,ug,ug,ug,ug,cg,ub,ub,ub,ub,cg
ug,ug,ug,ur,ug,ug,ub,ub,ub,ub,ur,cb,ur,ub,ub,ug,ug,ug,ub,ur,ub,ub,ug
ug,ug,ug,ug,cb,ub,ub,ug,ub,ub,ub,ub,ub,ub,ub,ur,ur,ub,ur,ur,ur,ur,ug
ug,ug,ug,ur,ug,ug,ub,ur,ub,ub,ub,ub,ub,ub,ug,ur,ur,ur,ur,ur,ur,ur,ug
ug,ug,ug,ug,cg,ug,ug,ub,ub,ub,ub,ub,ub,ub,ub,ur,ug,ug,ur,ur,ur,ur,ug
ug,ug,ug,ug,ur,ug,ug,ub,ub,ub,ub,ub,ub,ur,ur,ur,ur,ur,ur,ur,ur,ur,ug
cb,ug,ug,ug,ug,ug,ug,ub,ug,ug,ug,ub,ub,ub,ub,ub,ur,ug,ur,ur,ur,ur,ug
ug,ug,ug,ug,ug,ug,ug,ug,ug,ug,ug,ub,cg,ub,ub,ug,ur,ug,cr,ur,ur,cr,cb
cb,ug,ug,ug,ug,ug,cr,ug,ug,ug,ur,cg,cb,ub,ub,ub,ur,ur,ur,cr,ub,cr,cb