ux,ux,cr,ur,ur,ur,ur,cb,cb,cb,cg,ur,cg,ur,ur,ur,ur,ur,ur,cb,cb,ur,cb
ux,ug,ug,ur,ur,ur,cr,ux,ux,ux,ur,ur,ur,ur,ur,ur,ur,ur,ur,ur,ur,ur,ur
ux,ug,ug,ug,ur,ug,ug,ux,ux,ux,ur,ur,ur,ur,ur,ur,ur,ur,ur,ur,ur,ur,ur
cg,ug,ug,ug,ur,ug,ur,ur,ur,ur,ur,ur,ur,ur,ur,ur,ur,ur,ur,ur,ur,ur,ur
ur,cg,ug,ur,cg,ug,ur,ur,ur,ur,ur,ur,ur,ur,ur,ur,ur,ur,ur,ur,ur,ur,ur
ur,ur,ug,ur,ug,ug,ur,ur,ur,ur,ur,ur,ur,ur,ur,ur,ur,ur,ur,ur,ur,ur,ur
ur,ur,ug,cr,ur,ug,ur,ur,ur,ur,cg,ug,ug,ug,ux,ub,ur,ur,cb,ur,ur,ur,ur
ur,ux,ug,ug,ur,ur,ur,ur,ur,ur,ug,ug,ug,ug,ur,ur,ur,cr,ub,ur,ur,ur,ur
ur,ux,ux,ur,ur,ur,ur,ur,ur,ur,ux,ux,ux,ub,ux,ur,ur,ux,ux,ux,ux,cr,ur
ur,ur,ug,ug,ug,ug,cr,ub,ub,ur,ub,ub,ub,ub,ub,ur,ur,ux,ux,ux,ux,ub,ub
ur,ur,ug,ug,ug,ug,ug,ug,ux,ur,ub,ur,ug,ug,ug,cr,cb,ub,ub,ub,ub,ub,ub
cg,ub,ub,cb,ub,ub,ub,ub,ub,ur,ug,ug,cg,ub,ug,ug,ug,ug,ub,ub,ub,ub,ub
ur,ub,ur,ug,ub,ub,ug,ug,ux,ur,ux,ug,ug,ug,ug,ug,ug,ub,ub,ub,ub,ub,ub
ur,ub,ur,ux,ub,ub,ub,ug,ux,ur,ux,ug,ug,ug,ub,ur,ur,cr,ux,ux,ux,ub,ub
ux,ub,ux,ux,ub,ub,ug,ug,ub,ur,ux,ug,ug,ug,ub,ur,ug,ug,ux,ux,ux,ub,ub
ux,ub,ux,ux,ub,ub,ub,ub,ub,ur,ub,ub,ub,ub,ub,ur,ur,ur,ux,ux,ux,ub,ub
ux,ub,ur,ub,ub,ux,ux,ux,ub,ur,ur,ur,ur,ub,ub,ub,ub,ur,ub,ub,ub,ub,ub
ux,ub,ur,ub,ur,ur,ur,ur,ur,ur,ub,ub,ub,ub,ub,ub,ub,ur,ub,ub,ub,ub,ub
ux,ub,ur,ub,ub,ub,ub,ub,ub,ur,ur,cb,ub,ub,ub,cb,ub,ur,ub,ub,ux,ux,cb
cg,ub,ub,ub,ub,ur,ux,ux,ux,ur,ub,ub,ub,ux,ub,ub,ub,ur,ub,ub,ux,ux,ux
cb,ux,ur,ur,ub,ux,ux,ux,ux,ur,ur,ur,ub,ub,ub,ub,ub,ub,ub,ux,ux,ux,ux
ur,ur,ur,ur,ub,ux,ux,ux,cb,ux,ub,ub,cg,ux,ux,ux,ux,ux,ux,ux,ux,cr,ux
ur,ur,ur,ux,ub,ux,cr,ux,cr,ux,cb,cg,cb,ux,ux,ux,cr,ux,ux,cr,ux,cr,cb