ur,ur,cr,ub,cb,cr,ur,cb,cb,cb,ur,cg,cg,ur,ur,ur,ub,ur,ur,ur,cb,cb,cb
ur,ur,ur,ur,ur,ur,ur,ub,ub,ub,ub,ub,ub,ub,ub,ub,ub,ub,ub,ub,ub,ub,ub
ur,cr,ur,ur,ur,ur,ur,ub,ub,ur,ur,ur,ug,ug,ub,ub,ub,ub,ub,ub,ub,ub,ub
ub,ur,ur,ur,ur,ur,ur,ub,ur,ur,ur,ug,ug,ug,ur,ur,ur,ur,ur,ur,ur,ur,ub
ub,ur,ur,ur,ur,ur,ur,ur,ur,ur,ur,ug,ug,ug,ug,ug,ug,ug,ug,ur,ur,ur,ub
cg,ur,ur,ur,ur,ub,ur,ur,ur,ur,ur,ug,ug,ug,ug,ug,ug,ug,ug,ur,ur,ub,ub
cg,ur,ur,ug,ub,ub,ub,ug,ug,ur,ur,ur,ur,cb,ur,ug,ug,ug,ub,ur,ur,ur,ub
ur,ur,ur,ug,ug,ub,cr,ur,ur,ug,ug,ur,ur,ub,ub,ug,ub,ug,ug,ur,ur,ur,ub
ur,ug,ug,ur,ur,cr,ub,ub,ur,ub,ur,ur,ur,ub,ug,ug,ur,ug,ur,ur,ub,ur,ub
ur,ur,ur,ur,ug,ub,ub,ub,ub,cb,ur,ug,ub,ub,ur,ur,ur,ub,ug,ug,ub,ur,ub
ug,ur,ur,ug,ug,ur,ur,ur,ug,ur,ur,ur,ur,ub,ur,ug,ur,ub,ur,ug,ur,ur,ub
ug,ug,ug,ug,ug,ub,ub,ub,ug,ur,ub,ug,ub,ub,ur,ur,cg,ub,ub,ug,ub,ur,ub
ug,ug,ug,ug,ug,ub,ub,ub,ug,ur,ur,ur,ur,ub,ub,ub,ug,ub,ug,ug,ub,ub,ub
ug,ug,ug,ug,ug,ub,ub,ub,ug,ug,ub,ug,ug,ur,ur,ur,ug,ur,ur,ur,cb,ur,ub
cg,ug,ug,ug,ug,ub,ub,ur,ug,ug,ug,ug,ug,ug,cg,ug,cb,ub,ub,ub,ub,ub,ub
cb,ug,ug,cg,ug,ub,ub,ug,ug,ug,ug,ug,ug,ug,ug,ug,ug,ub,ub,ub,ub,ub,ub
ug,ug,ug,ug,ug,ur,ur,ug,ug,ug,ur,ug,ub,ur,ug,ug,ur,ur,ur,ur,ur,ub,ub
ug,ug,ug,ug,ug,ug,ug,ug,ug,ug,ug,ug,ug,ug,ug,ug,ur,ub,ub,ug,ub,ub,ub
ug,ug,ug,ug,ug,ug,ug,ug,ug,ug,ur,ug,ur,ug,ug,ub,ur,ug,ub,ub,ub,ur,ub
ug,ug,ug,ug,ug,ug,ug,ug,ub,ug,ug,ug,ug,ug,ug,ub,cr,ub,ub,ub,ub,ub,ub
cb,cb,ug,ug,ug,ug,ug,ug,ub,ur,ur,ug,ur,ur,ur,ur,ub,ur,ur,ur,ur,ur,ur
ug,ug,ug,ug,ug,ug,ug,ug,ug,ur,ur,ug,cg,ur,ur,ur,ub,ur,ur,ub,ub,cr,cb
cb,ug,ug,ug,ug,ug,cr,ug,cr,ur,ur,cg,cb,ur,ur,ur,ur,ur,ur,cr,ub,cr,cb