cr,cr,cr,ug,ug,ug,ur,cb,cb,cb,ur,cg,cg,ur,ur,ur,ub,ur,ur,ur,cb,cb,cb
cg,ub,ub,ub,ug,ug,ub,ub,ur,ur,ur,ur,ur,ur,ur,ur,ur,ur,ur,ur,ug,ug,ug
ug,ug,ug,ug,ug,ug,ug,ug,ur,ur,ur,ur,ur,ur,ur,ur,ur,ur,ur,ur,ub,ub,ub
ug,ug,ug,ug,ug,ug,ug,ub,ur,ur,ur,ur,ur,ur,ur,ur,cr,ub,ub,ur,ub,ub,ub
ug,ug,ug,ug,ug,ug,ug,ub,ur,ub,ub,ur,ur,ur,ur,ur,ur,ur,ur,ur,ub,ub,ub
ug,ug,ug,ug,ug,ug,ug,ug,ur,ub,ub,ub,ub,ur,ub,ub,ub,ub,ub,ub,ub,ub,ub
cg,ug,ug,ug,ug,ug,ug,ug,ur,ug,ub,ub,ub,ur,ur,ur,ur,ur,ur,ur,ub,ub,ub
ub,ug,ug,ug,ug,ug,ug,ug,ur,ub,ub,ub,ub,ur,ub,ub,ub,ub,ug,ur,ur,ur,ub
ug,ug,ug,ug,ug,ur,ur,ub,ur,cb,ub,ub,ub,ur,ug,ug,ur,ur,ur,ur,ub,ur,ub
ug,ug,ug,ug,ug,ub,ub,ub,ur,ub,ub,ub,ub,ur,ug,ug,ub,ub,ub,ur,ub,ur,ub
ug,ug,ug,ug,ug,ug,ug,ug,ur,ur,ub,ub,ub,ur,ug,ug,ug,ur,ur,ur,ur,ur,ub
ug,ug,ug,ur,ug,ur,ur,ur,ur,ug,ub,ub,cb,ug,ug,ug,ub,ur,ub,ur,ub,ur,ub
ug,ub,ug,ug,ug,ur,ur,cr,ub,ub,ub,ub,ub,ub,ub,ug,ug,ur,ug,ur,ub,ub,ub
ug,ug,ub,ub,ug,ur,ur,cb,ub,ub,ub,ug,ug,ug,ug,ug,ug,ur,ub,ur,ur,ur,ub
cg,ug,ug,ug,ug,ur,ur,ur,ur,ug,ug,ug,ug,ug,ug,ug,ur,ur,ug,ur,ub,ub,ub
ug,ug,ug,ub,ug,ur,ur,ur,ur,cg,ug,ug,ug,ug,ug,ug,ug,ug,ug,ur,ub,ub,ub
ug,ug,ug,ug,ug,ur,ur,ur,ur,ub,ur,ur,ub,ur,ub,ub,ur,ub,ug,ur,ur,ur,ub
ug,ug,ug,ug,ug,ur,ug,ur,ur,ub,ur,ub,ub,ur,ub,ug,ug,ug,ug,ur,ur,ur,ub
ug,ug,ug,ub,ug,ug,cg,ug,ub,ub,ub,ub,ur,ur,ur,ub,ub,ub,ur,ur,ur,ur,ub
ug,ug,cr,ur,cb,ub,ub,ub,ub,ub,ub,ub,ub,ub,ub,ub,cb,ub,ub,ur,ub,ub,ub
cb,ug,ug,ug,cb,ub,ub,ub,ub,ub,ub,ub,ub,ub,ub,ub,ub,ug,ur,ur,ur,ur,ug
ug,ug,ug,ug,ug,ug,ug,ug,ug,ug,ug,cg,cg,ub,ub,ub,ub,ug,ur,ur,ur,cr,cb
cb,ug,ug,ug,ur,ur,cr,ug,cr,ub,ub,cg,cb,ub,ub,ub,ur,ur,ur,cr,ub,cr,cb