ux,ux,cr,ur,ur,ug,ux,cb,cb,cb,cg,cg,cg,ur,ur,ur,ur,ur,ur,ur,cb,cb,cb
ur,ug,ug,cr,ur,ug,ug,cg,ur,ur,ur,ur,ur,ur,ur,ur,ur,ur,ur,ur,ur,ub,cr
ux,cr,ug,ug,ur,cg,ug,ug,ur,ux,ur,ur,ur,ur,ur,ux,ux,ux,ur,ur,cb,ub,ur
cb,ur,ur,ug,ur,ur,ur,ug,ur,ux,ux,ux,ux,ur,ur,ur,ux,ux,ur,ur,ur,ur,ur
ug,ur,ur,ug,ur,ur,ur,ug,ur,ux,ux,cr,ux,ur,ur,ur,ur,ur,ur,ur,ur,ur,ur
ux,ug,ug,ug,ug,cg,ur,ur,ur,ur,ux,ur,ur,ur,ur,ur,ur,ur,ur,ur,ur,ur,ub
ux,ux,ux,ux,ur,ur,ur,ur,ur,ur,cr,cg,ur,ur,ur,ur,ur,ur,ur,ur,ur,ur,ur
ux,ux,ux,ur,ur,ur,ur,ur,ur,ur,ur,ug,ur,ur,ur,ur,ur,ur,ur,ur,ur,ur,ur
ur,ur,ur,ur,ur,ur,ur,ur,ur,ur,ub,ug,ub,ur,ur,ur,ur,ub,ub,ur,ur,ur,ur
ur,ur,ur,ur,ur,ur,ur,ur,ur,ur,ub,ug,cr,ug,ur,ur,ur,ub,ub,cb,ug,ug,ur
ur,ur,ur,ur,ur,cb,ub,ub,ub,ub,ub,ub,ur,ur,ur,ur,ub,ub,ug,ug,ug,ur,ux
ur,ur,ur,ur,ur,ug,ur,ux,ug,ug,ug,ug,ug,ug,ur,ur,cg,ug,ug,ub,cr,ur,ux
ux,ux,ux,ux,ux,ug,ug,ug,ug,ux,ux,ux,ux,ux,ux,ug,ug,ug,ug,ub,ur,ur,ux
ur,ur,ur,ur,ur,ug,ug,ug,ug,ug,cb,ux,ux,ux,ux,ug,ug,ug,ug,ub,ur,ur,ux
ur,ur,ur,ur,ur,ur,ur,ur,ur,ur,ur,ur,ur,ur,ur,ur,ur,ur,ur,ur,ur,ur,ux
ur,ur,ur,ur,ur,ur,ug,ug,ur,ug,ug,ug,ug,ug,ug,ug,ug,ug,ug,ug,ug,ug,ux
ur,ur,ur,ur,ur,cr,ub,ug,ug,ur,ux,ug,ur,ur,ur,ur,ur,ur,ur,ur,ur,ur,ur
ur,ur,ur,ur,ur,ur,ur,ur,ur,ur,ur,ur,ur,ur,ur,ur,ur,ur,ur,ur,ur,ur,ux
ur,ur,ur,ub,ub,ub,ub,ub,ub,ur,ug,ug,ur,ug,ug,ur,ur,ur,ur,ur,ur,ur,cb
cg,ux,ux,ux,ub,ub,ub,ub,ub,ub,ug,ug,ug,ug,ub,ub,ub,ub,ub,ub,ur,ux,ux
cb,ux,ux,ux,ub,ub,ub,ub,ub,ub,ug,ug,ux,ux,ux,ux,ub,cb,ub,ub,ur,ux,ux
ux,ux,ux,ux,ux,ub,ub,ub,cb,ub,ur,ur,cg,ux,ux,ux,ub,ub,ub,ub,ur,cr,cb
cb,ux,ux,ux,ux,ux,cr,ub,cr,ur,ur,cg,cb,ux,ux,ux,cr,ux,ux,cr,ur,cr,cb