ug,ug,cr,ub,cb,ub,ub,cb,cb,cb,ur,cg,cg,ug,ug,ug,ug,ur,ur,ur,cb,cb,cb
ug,ug,ug,ug,ug,ub,ub,ug,ug,ug,ug,ug,ug,ug,ug,ub,ug,ur,ur,ur,ur,ur,cr
ug,cr,ub,ub,ur,ub,ub,ur,ur,ur,ur,ur,ug,ug,ug,ub,ug,ur,ub,ub,ub,ub,ub
ug,ur,ub,ur,ur,ub,ur,ur,ur,ur,ur,ub,ur,ur,ur,ur,ug,ur,ur,ur,ur,ur,ub
ug,ug,ug,ug,ug,cg,ur,ur,ur,ur,ur,ur,ur,ub,ug,ug,ug,ur,ug,ur,ur,ur,ub
cg,ur,ur,ur,ur,ug,ug,ug,cg,ur,ur,ur,ug,ub,ug,ug,ug,ur,ug,ur,ur,ub,ub
cg,ur,ur,ur,ur,ug,ur,ur,ur,ur,ur,ur,ur,ub,ur,ug,ug,ur,ub,ur,ur,ur,ub
ur,ur,ur,ur,ur,ug,ug,ug,ug,ug,ur,ur,ur,ub,ub,ug,ug,ur,ug,ur,ur,ur,ub
ur,ur,ur,ur,ur,ug,ug,ur,ur,ur,ur,ur,ur,ub,ug,ug,ug,ur,ur,ur,ub,ur,ub
ub,ub,ub,ub,ur,ur,ur,ur,ur,ur,ur,ur,cr,ub,ur,ur,ug,ur,ug,ug,ub,ur,ub
ub,ug,cb,ub,ub,ub,ub,ug,ug,ur,ur,ur,ur,ub,ur,ug,ug,ur,ur,ug,ur,ur,ub
ub,ug,ub,ub,ug,ug,ub,ub,ug,ur,ur,cr,ug,ub,ur,ur,ug,ur,ub,ug,ub,ur,ub
ub,ub,ub,ub,ug,ug,ub,ug,ug,ur,ug,ur,ug,ug,ug,ub,ug,ur,ug,ug,ub,ub,ub
cb,ug,ug,ug,ug,ug,ub,ug,ug,ug,ug,ug,ug,ur,ug,ur,ub,ur,ub,ur,ub,ub,ub
cg,ub,ub,ub,ub,ug,ub,cb,ub,ub,ub,ub,ub,ub,ub,ub,ub,ub,ub,ub,ub,ub,ur
cb,ub,ug,ug,ub,ug,ub,ur,ur,ur,ub,ub,ub,ub,ub,ub,ub,ub,ub,ub,ub,ub,ur
ub,cg,ug,ug,ur,ur,ur,ur,ug,ur,ug,ug,ug,ug,ug,ug,ug,ur,ub,ub,ub,ub,ur
ub,ub,ug,ug,ug,ug,ug,ug,ug,ur,ug,ug,ug,ug,ug,ur,ur,ur,ub,ub,ub,ub,ur
ub,ub,ug,ug,ug,ug,ug,ug,cr,ur,ur,ug,ur,ug,ug,ur,ur,ur,ub,ub,ub,ur,ur
ub,ub,ug,ug,ug,ug,ug,ug,ug,ug,ug,ug,ug,ug,ug,ur,ur,ur,ur,ub,ub,ur,ur
cb,cb,ug,ug,ug,ug,ug,ug,ug,ur,ur,ug,ur,ur,ur,ur,ur,ur,cb,ub,ub,ur,ur
ug,ug,ug,ug,ug,ug,ug,ug,ug,ur,ur,ug,cg,ur,ur,ur,ur,ur,ur,ub,ub,cr,cb
cb,ug,ug,ug,ug,ug,cr,ug,cr,ur,ur,cg,cb,ur,ur,ur,ur,ur,ur,cr,ub,cr,cb