cg,ug,cr,ur,ur,ur,ur,cb,cb,cb,cg,ur,cg,ur,ur,ub,ub,cb,ub,cb,cb,ux,cb
ur,ur,ur,ur,ur,ur,ur,ur,ur,ur,ur,ur,ur,ur,ur,ub,ub,ub,ub,ub,ub,cb,cb
ur,cr,ur,ur,cg,cb,ur,ur,ur,ur,ur,ur,ur,ux,ur,ub,ub,ub,ux,ux,ux,ux,ur
cg,ur,ur,ur,ug,ub,ur,cr,ug,ug,ug,ur,ur,ux,ur,ux,ux,ux,ux,ux,ux,ur,ur
ug,ug,ug,cr,ug,ub,ur,ug,ur,ur,cg,ur,ur,ur,ur,ur,ur,ur,ur,ur,ub,ub,ur
ug,ug,ug,ub,ub,ub,ur,ur,ur,ur,ur,ur,ur,ur,ur,ur,ur,ur,ur,ur,ur,cr,ur
ug,ug,ur,ub,ub,ug,ur,ur,ur,ur,ug,ub,ub,ub,ux,ux,ux,ux,ux,ux,ub,ur,ur
ur,ug,ug,ug,ub,ug,ur,ug,ug,ug,cr,ub,ug,ug,ux,ux,ub,ub,ub,ux,ub,ur,ur
ur,ur,ur,ur,ub,ub,ur,ub,ub,ub,ur,ub,ug,ux,ux,ux,ux,ux,ub,ub,ub,ub,ur
ux,ur,ur,ug,ur,ur,ur,ur,ur,ur,ur,ur,ub,ub,ub,ub,ur,ub,ub,ub,ub,ub,ur
ur,ur,ur,ur,ur,ur,ur,ur,ur,ur,ur,ur,ug,ug,ug,ug,ug,ug,ug,ug,ur,ub,ur
ur,ur,ur,ur,ur,ur,ur,ur,ur,ur,ur,ur,ug,ub,ug,ug,ug,ug,ug,ug,ur,ur,ur
ub,ub,ub,ub,ub,ub,ur,ub,ug,ug,ub,ub,cg,ub,ug,ug,ug,ug,ug,ug,ur,ur,ux
ub,ub,ub,cb,ub,ub,ur,ub,ug,ub,ug,ur,ux,ur,ur,ug,ug,ug,ug,ug,ur,ur,ux
ub,ub,ub,ux,ux,ux,ub,ub,ub,ub,ub,ur,ux,ur,ux,ux,ub,ub,ug,ug,ur,ux,ux
ub,ub,ub,ub,ur,ur,ur,ux,ux,ub,ug,ur,ur,ur,ug,ug,ub,ub,ug,ug,ur,ux,ux
ub,ub,ub,ub,ur,ux,ux,ux,ux,ub,cb,ux,ux,ux,ug,ux,ur,ub,ur,ur,ur,ux,ux
ux,ux,ux,ux,ur,ux,ux,ux,ux,ux,ug,cb,cg,ux,ug,ug,ub,ub,ug,ug,ux,ux,ux
ux,ux,ux,cr,ur,ux,ux,ux,ux,ux,ux,ub,ux,ux,ux,ux,ub,ub,ux,ux,ur,ur,cb
cg,ux,ux,ur,ur,ux,ux,ux,ux,ux,ux,ub,ub,ub,ub,ux,ub,ub,ux,ux,ur,ur,ur
cb,ux,ux,ur,ur,ux,ux,ux,ux,ux,cr,ur,ur,ur,ur,ur,ur,ur,ur,ur,ur,ur,ur
ur,ur,ur,ur,ur,ux,ux,ux,ux,ux,ux,ux,cg,ux,ub,ub,ub,ur,ur,ur,ur,cr,ur
ur,ur,ur,ur,ur,ux,cr,ux,cr,ux,ux,cg,cb,ux,ux,ux,cr,ux,ux,cr,ur,cr,cb