ur,ur,cr,ur,ur,cr,ur,cb,cb,cb,cg,cg,cg,ur,ur,ur,cr,ux,ux,ux,cb,cb,cb
cg,ur,cb,ur,cb,ub,ur,ur,ur,ur,ux,ur,ur,ur,ux,ux,ux,cr,ux,ux,ux,ux,ux
ur,cr,cr,ur,ur,cr,ur,ur,ur,ur,ur,ur,ux,ur,ub,ub,ux,ur,ux,ux,ux,ux,ux
ur,ur,ub,ub,ub,cr,ur,ur,ur,ur,ur,ur,ur,ur,ub,ub,ur,ur,ug,ug,ux,ux,ux
ur,ur,ur,ur,ub,ur,ur,ur,ur,ur,ur,ur,ur,ur,ub,ur,ur,ur,ux,ug,ux,ux,ux
ur,ur,ur,ur,ub,ur,ur,ur,ug,ur,ur,ur,ur,ug,ub,ub,ub,ug,ug,ug,ux,ux,ux
ur,ur,ur,ug,ug,ug,ug,ug,ug,ur,ur,ur,ur,ug,ub,ub,ub,ux,ug,ug,ug,ur,ux
ub,ub,ub,ug,ug,ug,ug,ug,ug,cg,ur,ur,ur,ug,cb,ug,ug,ug,ug,ug,ug,ur,ux
ub,ub,ub,ux,ux,ug,ub,ur,ur,ur,ug,ug,ug,ug,ug,ug,ug,ug,ug,ur,ug,ur,ux
ub,ub,ub,ug,ug,ug,ub,ug,ug,ug,ug,ug,ug,ug,ug,ur,ur,cg,ub,ug,ug,ur,ux
ub,ub,ub,cg,ux,ug,ug,ug,ug,ub,ug,ug,ug,ub,ug,ur,ug,ur,ug,ug,ug,ux,ux
ub,ub,ug,ug,ug,ug,ug,ug,ug,ur,ub,ug,ug,ug,ug,ug,ug,ur,ug,ug,ug,ur,ur
ub,ub,ug,ug,ug,ug,ug,ug,ug,cb,ug,cg,ug,ub,ug,ug,ub,ur,ug,ug,ug,ux,ur
ux,ub,ug,ug,ug,ug,ug,ug,ux,ub,cb,ub,ub,ub,ub,ur,ug,ur,ur,ug,ux,ux,ur
ux,ub,ub,ur,ur,ug,ur,ug,ur,ub,ub,ub,ub,ub,ub,ur,ur,ur,ur,ug,ux,ux,ur
ux,ub,ub,ux,ug,ug,ug,ug,ux,ub,ub,ub,ub,ub,ub,ur,ux,ug,ur,ur,ur,ur,ur
ux,ub,ur,ux,ug,ug,ux,ur,ux,ux,ux,ux,ug,ug,ug,ur,ux,ux,ur,ur,ux,ux,ux
ux,ub,ub,ux,ug,ug,ux,ur,ux,ux,ux,ux,ux,ux,ux,ur,ux,ux,ur,ur,ux,ux,ux
cb,ub,ub,ux,ux,ux,ux,ur,ux,ux,ux,ug,ug,ux,ux,ur,ug,ux,ur,ur,ux,ux,cb
cg,ux,ub,ux,ux,ux,ux,ur,ux,ux,ux,ug,ug,ug,ug,ur,ug,ux,ur,ur,ux,ux,ux
cb,ub,ub,ur,ur,ur,ur,ur,ux,ux,ux,ux,ux,ux,ux,cr,ug,ug,ug,ur,ux,ux,ux
ux,ub,ux,ux,ux,ux,ux,ux,ux,ux,ux,ux,cg,ux,ux,ug,ug,ug,ug,ur,ux,cr,cb
cb,ux,ux,ux,ux,ux,cr,cb,cr,ux,ux,cg,cb,ux,ux,ux,cr,ux,ux,cr,ux,cr,cb