ur,ur,cr,ug,cb,ub,ur,cb,cb,cb,cg,ux,cg,ux,ux,ur,ur,ur,ur,cb,cb,ur,cb
ur,cg,ug,ug,ur,ur,ur,ur,ur,ux,ux,ur,ur,ur,ur,ur,ur,ur,ur,ur,ur,ur,ur
ur,ur,cr,cr,ur,ur,ur,ur,ur,ux,ur,ur,ur,ur,ur,ur,ur,ur,ur,ub,cb,ur,ur
cg,ur,ur,ug,ug,ur,ur,ub,ur,ur,ur,ur,ur,ur,ur,ur,ur,ur,ub,ub,ub,ur,ux
ur,ur,ur,cg,cr,ur,ur,ur,ur,ur,ur,ur,ur,ur,ur,ub,ub,ux,ux,ub,ub,ur,ux
ur,ur,ur,ur,ug,ug,ur,ub,ux,ux,ur,ur,ur,ux,ux,ux,ux,ub,ub,ub,ur,ur,ux
ur,ur,ur,ur,ug,ug,ur,ug,ug,ug,cb,ub,ub,ub,ug,ux,ux,ub,ur,ux,ux,ux,ux
ur,ur,ur,cb,ug,ug,ub,ub,ub,ub,ux,ub,ur,ub,ug,ur,ub,ub,ub,ub,ub,ub,ux
ur,cr,ub,ub,ug,cg,ub,ub,ub,ub,ux,ub,ux,ub,ug,ug,ug,ub,ub,ub,ub,ub,ux
ur,ur,ub,ux,ux,ub,ux,ub,ub,ub,ux,ub,ux,ub,ug,ug,ug,ug,ug,ug,ug,ub,ub
ur,ur,cr,ux,ux,ub,ux,ub,ub,ub,ub,ub,ub,ub,ug,ug,ug,ug,ug,ub,ug,ub,ub
cg,ur,ur,ur,ur,ub,ub,ub,ub,ub,ub,ub,ub,ub,ug,ug,ug,ug,ug,ug,ug,ur,ur
ub,ur,ub,ub,ub,ug,ug,ug,ub,ub,cb,ug,ub,ug,ub,ux,cg,ug,ug,ug,ux,ux,ur
ub,ur,ug,ug,ug,ug,ug,ug,ub,ub,ub,ub,ub,ug,ub,ug,ug,ug,ug,ug,ux,ux,ur
ub,ur,ug,ug,ub,ub,ux,ug,ub,ub,ub,ub,ub,ug,ub,ug,ur,ur,ur,ur,ur,ur,ur
ub,ur,ur,ur,ur,ur,ur,ur,ur,ur,ur,ur,ur,ur,ur,ur,cr,ur,ur,ur,ur,ur,ur
ub,ub,ub,ub,ub,ub,ub,ub,ub,ub,ub,ub,ug,ur,ur,ur,cr,ux,ux,ux,ux,ur,ux
ub,ub,ub,ub,ub,ub,ub,ub,ub,ub,ub,ub,ub,cb,ur,ux,ux,ux,ux,ux,ux,ur,ux
cb,ux,ux,ux,ux,ux,ux,ux,ux,ur,ub,ub,ux,ug,ur,ur,ur,ur,ur,ur,ur,ur,cb
cg,ux,ux,ux,ux,ux,ux,ux,ux,ur,ub,ub,ux,ux,ux,ux,ux,ux,ux,ux,ux,ux,ux
cb,ux,ux,ux,ux,ux,ux,ux,ux,ur,ur,ux,ux,ux,ux,ux,ux,ux,ux,ux,ux,ux,ux
ux,ux,ux,ux,ux,ux,ux,ux,ux,ur,ur,ux,cg,ux,ux,ux,ux,ux,ux,ux,ux,cr,ux
ux,ux,ux,ux,ux,ux,cr,ux,cr,ur,ur,cg,cb,ux,ux,ux,cr,ux,ux,cr,ux,cr,cb