ur,ur,cr,ur,ur,cr,ub,cb,cb,cb,cg,ux,cg,ux,ux,ur,ur,ur,ur,cb,cb,ur,cb
ur,ur,ur,ur,ur,ur,ub,ub,ub,ub,ub,cb,ux,ux,ux,ux,ur,ur,ur,ur,ub,ub,ur
ur,ur,ur,ur,ur,ur,ur,ur,ur,ux,ux,ur,ur,ur,ur,ur,ur,ur,ur,ub,ub,ub,ur
cg,ur,ug,cr,ug,ug,cg,cr,ur,ur,ur,ur,ur,ux,ur,ur,ur,ur,ur,cr,ub,cb,ux
ur,ur,ug,cg,ug,ug,ur,ur,ur,ur,ur,ur,ur,ur,ur,ub,ur,ux,ux,ub,ub,ur,ux
ur,ur,ur,ur,ur,ug,ur,ur,ur,ur,ur,ur,ur,ux,ux,ux,ur,ub,ub,ub,ux,ur,ux
ur,ur,ur,ur,ur,ur,cb,ub,ub,ur,ur,cr,ub,ub,ug,ux,ur,ub,ux,ux,ux,ux,ux
ur,ur,ur,ur,ur,ub,ub,ub,ub,ur,ur,ub,ux,ub,ug,ux,ur,ub,ub,ux,ub,ub,ux
ur,ub,cr,ur,ub,ub,ub,ub,ub,ub,cb,ub,ub,ub,ug,ug,cg,ub,ub,ub,ub,ub,ux
ur,ub,ub,ub,ub,ug,cg,ub,ub,ub,ux,ub,cg,ub,ug,ug,ug,ug,ug,ug,ug,ub,ub
ur,ub,ur,ux,ug,ug,ug,ub,ub,ub,ug,ug,ug,ub,ug,ug,ug,ug,ug,ub,ug,ub,ub
ug,cb,ug,ug,ug,ug,ug,ug,ug,ub,ug,ub,ub,ub,ug,ug,ug,ug,ug,ug,ug,ur,ur
ub,ur,ub,ub,ub,ug,ug,ug,ug,ug,ug,ub,ub,ug,ug,ug,ug,ug,ug,ug,ux,ux,ur
ub,ur,ug,ug,ug,ug,ug,ug,ub,ug,ug,ub,ub,ug,ug,ug,ug,ug,ug,ug,ux,ux,ur
ub,ur,ug,ug,ub,ux,ux,ug,ub,ub,ub,ub,ub,ug,ug,ug,ug,ux,ux,ux,ux,ux,ur
ub,ur,ur,ur,ur,ur,ur,ur,ur,ur,ur,ur,ur,ur,ug,ur,ug,ur,ur,ur,ur,ur,ur
ub,ub,ub,ub,ub,ub,ub,ub,ub,ub,ub,ub,ug,ub,ug,ug,ug,ub,ub,ub,ux,ur,ux
ub,ub,ub,ub,ub,ub,ub,ub,ub,ub,ub,ub,ub,ub,ur,ux,ux,ux,ux,ub,ux,ur,ux
cb,ux,ux,ux,ux,ux,ux,ux,ux,ur,ub,ub,ux,ug,ur,ur,ur,ur,ur,ub,ur,ur,cb
cg,ux,ux,ux,ux,ux,ux,ux,ux,ur,ub,ub,ux,cr,ur,ux,ux,ux,ux,ub,ux,ux,ux
cb,ux,ux,ux,ux,ux,ux,ux,ux,ur,ur,ux,ux,ux,ur,ux,ux,ux,ux,ub,ux,ux,ux
ux,ux,ux,ux,ux,ux,ux,ux,ux,ur,ur,ux,cg,ux,ur,ur,cb,ub,ub,ub,ux,cr,ux
ux,ux,ux,ux,ux,ux,cr,ux,cr,ur,ur,cg,cb,ux,ux,ux,cr,ux,ux,cr,ux,cr,cb