ur,ur,cr,ur,ur,ur,ur,cb,cb,cb,cg,ur,cg,ur,ur,ur,ur,ur,ur,cb,cb,ub,cb
ur,ur,cr,cg,ug,ug,ug,ug,ur,ur,ur,ur,ur,ur,ur,ur,ur,ur,ur,cb,ub,ub,ub
ur,cg,ug,ur,cr,ug,ug,ug,ur,ur,ur,ur,ur,ur,ur,ur,ur,ur,ur,cr,ur,ub,ub
cb,ug,ug,ur,ur,ug,ug,ug,ur,ur,ur,ur,ur,ur,ur,ur,ur,ur,ur,ur,ur,ur,ur
ur,ur,ur,ur,ur,ug,ug,ug,ug,ur,ur,ur,ur,ur,ur,ur,cr,ur,ur,ur,ur,ur,ur
ur,ur,ur,ur,ur,ug,ug,ug,ug,ur,ur,ur,ur,ur,ur,ug,ur,ur,ur,ur,ur,ur,ur
ur,ur,ur,ur,ug,ug,ug,ug,ug,ur,ur,ub,ub,ug,cg,ug,ur,ux,ur,ur,ub,ur,ur
ux,ux,ug,ug,ug,ug,ug,ug,ug,ur,ur,ub,ub,ur,ur,ur,ur,ur,ur,ur,ur,ur,cr
ux,ux,ux,ux,ug,ug,ug,ug,ux,cb,ub,ub,cr,ur,ur,ur,ur,ug,ub,ub,ub,ux,ux
ux,ux,ux,ux,ug,ug,ug,ug,ug,ub,ug,ub,ub,ub,ub,ub,ur,ug,ur,ux,ux,ux,ux
cg,ug,ug,ug,ug,ug,ub,ug,ug,ub,ub,ub,ub,ub,cb,ub,ub,ug,ub,ux,ux,ux,ux
cg,ug,ug,ug,ug,ug,ug,ug,ug,ug,ug,ub,ub,ub,ub,ub,ub,ug,ub,ux,ux,ux,ux
ux,ux,ux,ug,ug,ug,ug,ug,ux,ux,ug,ux,ub,ub,ub,ug,ug,ub,ub,ux,ux,ux,ux
ur,ur,ug,ug,ug,ug,ug,ug,ur,ur,ug,ug,ur,ur,ur,ug,ur,ur,ur,ur,ur,ur,ux
ur,ux,ug,ug,ug,ug,ux,ug,ug,ug,ug,ug,ub,ub,ug,ug,ub,ub,ub,cb,ub,ub,ux
ur,ux,ux,ux,ub,ub,ub,ub,ub,ux,ug,ub,ub,ub,ub,ub,ub,ub,ub,ug,ur,ub,ug
ur,ux,ux,ux,ub,ub,ub,ub,ub,ux,ug,ub,ub,ub,ub,ub,ub,ub,ub,ug,ub,ub,ug
ur,ux,ux,ux,ub,ux,ux,ub,ub,ux,ug,ub,ux,ux,ub,ub,ub,ub,ub,ub,ub,ug,ug
ur,ur,ur,ur,ur,ub,ub,ub,ub,ub,cb,ur,ur,ur,ur,ur,ur,ur,ur,ur,cr,ur,cb
cg,ux,ux,ux,ux,ub,ux,ux,ux,ub,ub,ux,ux,ux,ux,ux,ug,ur,ub,ub,ur,ux,ux
cb,ux,ux,ux,ub,ub,ux,ux,ux,ub,ub,ux,ux,ux,ux,ux,ux,ur,ur,ur,ur,ux,ux
ux,ux,ub,ub,ub,ub,ub,ub,ub,ub,ub,ux,cg,ux,ux,ux,ux,ur,ur,ur,ur,cr,ub
ux,ux,ub,ub,ub,ub,cr,ux,cr,ub,cb,cg,cb,ux,ux,ux,cr,ur,ur,cr,ur,cr,cb