ur,ur,cr,ur,ur,ur,cg,cb,cb,cb,ur,cg,cg,ur,ur,cr,ux,ux,ux,ux,cb,cb,cb
ur,ur,ur,ur,ur,ur,ur,ur,ur,ur,ur,ux,cb,ur,ux,ux,ux,ur,ux,ux,ur,ur,ur
ur,cr,ur,ux,ur,ur,ug,ux,cr,ur,ur,ux,ug,ur,ug,ug,ug,ug,ug,ug,cg,ur,ur
ur,ur,ur,ux,ux,ux,ug,ux,ux,ux,ug,ux,ug,ur,ur,ux,ur,ur,ur,cb,ub,ub,ub
ur,ur,ux,ux,ux,ux,ug,ux,ub,ux,ug,ux,ug,ux,ur,ug,cr,ur,ur,ug,ur,ur,ub
ur,ur,ur,ub,ub,cb,ub,ub,ub,ub,ug,ux,ug,ur,ur,ug,ur,ur,ur,ur,ur,ur,ub
ur,ur,ur,ub,ub,ur,ur,ur,ur,ub,ug,ux,ug,ur,ur,ur,ur,ur,ug,ug,ub,ux,ux
ur,ur,ur,ur,cb,ur,ur,ur,ur,cr,ub,ux,ug,ux,ur,ur,ur,ux,ug,ux,ub,ux,ux
ur,ur,ur,ur,ur,ur,ur,ur,ub,ub,ub,ub,ug,ur,ug,ug,ug,ub,ug,ug,ub,ux,ux
ur,ux,ur,ur,ur,ur,cr,ur,ub,cr,ub,ux,ug,ur,ug,ug,ug,ug,ug,cg,ux,ux,ux
ur,ux,ur,ur,ur,ur,ub,ub,ub,ur,ug,ug,ug,ur,ug,ux,ux,ux,ux,ub,ux,ux,ux
ur,ux,ux,ux,ux,ux,cb,ub,ub,ur,ug,ug,ux,ux,ug,ux,ux,ux,ux,ub,ux,ux,ux
ur,ux,cr,ux,ux,ux,ux,ub,ub,ur,ug,ug,ux,ux,ug,ux,ux,ux,ug,ub,ux,ux,ux
ur,ux,ur,ux,ux,ux,ux,ub,ub,ur,ug,ug,ug,ug,ug,ux,ux,ux,ux,ub,ux,ux,ux
ur,ux,ur,ux,ux,ux,ux,ub,ub,ur,ug,ub,ub,ub,ux,ux,ux,ux,ux,ub,ux,ux,ux
ur,ur,ur,ub,ub,cb,ux,ux,ub,ur,ug,ub,ub,ub,ux,ux,ux,ux,ux,ub,ux,ux,ux
ur,ur,ub,ub,ub,ub,ux,ux,ux,ur,ug,ub,ub,ux,ux,ux,ux,ub,ub,ub,ux,ux,ux
ur,ur,ur,ub,cg,ub,ur,ur,ur,ur,ug,ux,ux,ux,ux,ux,ux,ux,ux,ux,ux,ux,cg
ur,ug,ug,ug,ug,ub,ur,ur,ur,ux,ug,ux,ux,ux,ux,ux,ux,ux,ux,ux,ux,ux,cb
cg,ug,ux,ug,ux,ux,ux,ux,ux,cg,ug,ux,ux,ux,ux,ux,ux,ux,ux,ux,ux,ux,ux
cb,ug,ug,ug,ux,ux,ux,ux,ux,ug,ug,ux,ux,ux,ux,ux,ux,ux,ux,ux,ux,ux,ux
ux,ux,ux,ux,ux,ux,ux,ux,ux,ug,ug,ux,cg,ux,ux,ux,ux,ux,ux,ux,ux,cr,cb
cb,ux,ux,ux,ux,ux,cr,cb,cr,ug,ug,cg,cb,cb,ux,ux,ux,ux,ux,cr,ux,cr,cb