cb,cr,cr,ub,ur,ur,cr,ub,ub,ub,ub,cb,ub,ub,ub,cb,ub,ub,ub,ub,ub,cb,cb
ur,ur,ug,ug,ur,ur,ub,ub,ub,ub,ub,ub,ub,ub,ub,ub,ub,ub,cb,ub,ub,cb,cb
ur,ur,ug,ug,ur,ur,ur,ub,ur,ub,ub,ub,ub,cb,ub,cb,ub,ub,ub,ub,ub,ub,ub
ur,ug,ug,ug,ug,ug,cg,ub,ur,ur,ub,ub,ub,ub,ub,ub,ub,ub,ub,ub,ub,ub,ub
ug,ug,ug,ur,ub,ur,ur,ur,ur,ur,ux,ug,ub,ub,ub,ub,ub,ub,ub,ur,ub,ub,ub
ug,ug,ug,ug,ug,cg,ur,ur,ur,ur,ub,ub,ub,ub,ub,ub,ur,ur,ur,ur,ub,ur,ur
ug,ur,ub,ur,ub,ub,cb,ur,ub,ub,ub,ur,cr,ub,ug,ub,ug,ub,ub,ux,ub,ub,ur
ug,ub,ub,ub,ub,ub,ur,ub,ub,ur,ur,ur,ub,ub,ub,ub,ug,ux,ub,ux,ub,ub,cr
cg,ub,ub,ur,ub,ur,ur,ug,ur,ur,ub,ug,ub,ub,ug,ub,ub,ub,cb,ux,ub,ub,ub
ug,ug,ur,ur,ub,ur,ur,ur,ur,ur,ub,ug,ug,ub,ub,ug,ug,ug,ug,ux,ub,ub,ub
ub,ub,ub,ur,ub,ur,ur,ux,ux,ur,ub,ub,ug,ug,ub,ug,ug,ug,ug,ux,ub,ub,ub
ub,ub,ub,ub,ub,ux,ux,ux,ux,ur,ub,ub,ub,ub,ug,ug,ug,ug,ug,ub,ub,ub,ub
ub,ub,ub,ug,ug,ug,ug,ug,ug,ug,ug,ug,ug,ug,ug,ug,ug,cg,ug,ub,ub,ub,ub
ub,ub,ub,ug,ug,ux,ux,ux,cg,ur,ux,ux,ux,ub,ub,ub,ug,ug,ub,ub,ub,ub,ub
ur,ur,ub,ur,ug,ug,ug,ug,ug,ur,ur,ur,ur,ub,ub,ux,ur,ub,ug,ug,ub,ur,ur
ur,ux,ub,ux,ug,ug,ug,ug,ur,ur,ux,ux,ux,ub,ub,ux,ur,ub,ux,ub,ub,ur,cr
ur,ux,ub,ux,ux,ux,ux,ug,ur,ug,ug,ux,ub,ub,ub,ux,ub,ub,ux,cb,ux,ur,ux
ur,ur,ub,ur,ur,ur,ur,ur,ur,ug,ur,ub,ub,ub,ub,ug,ub,ug,ug,ux,ub,ub,ux
ug,ub,ub,ub,ub,ux,ux,ur,ur,ur,ur,ur,ux,ux,ub,ux,ub,ug,cg,ub,ub,ub,ub
ug,ub,ux,ug,ub,ub,ub,ub,ur,ur,ur,ub,ux,ux,ub,ub,ub,ug,ug,ub,ub,ub,ux
ug,ub,ub,ug,ug,ur,cr,ur,ur,ub,ub,ub,ub,ub,ub,ub,ub,ug,ug,ub,ur,ub,ur
ug,ub,ub,ug,cg,ur,ur,cr,cr,ur,ub,ub,ub,ub,ub,ub,ub,ug,ug,ur,ur,ub,cr
cg,cb,ub,ug,ug,ux,cr,cg,cr,cr,ug,cg,ub,ub,cb,ug,ug,cg,ug,ug,cb,ur,cr