ub,ub,cr,ur,ur,ur,ur,cb,cb,cb,cg,ur,cg,ur,ur,cb,ur,ur,ur,cb,cb,ur,cb
cr,cb,cr,ur,ur,ur,ur,ur,ur,ur,ur,ur,ur,ur,ur,ur,ur,ur,ur,ur,ur,ur,cb
ub,ub,cg,ug,ur,ur,ur,ur,ur,ur,ur,ur,ur,ur,ur,ur,ur,ur,ur,ur,ur,ur,ur
ug,ur,ug,ug,ur,ug,ub,ug,ur,ur,cr,ur,ur,ur,ur,cr,ug,ug,ug,ur,ur,ur,ur
ug,ur,ur,ur,ur,ug,ug,ug,ub,ug,ub,ur,ux,ur,ur,ur,ur,ur,ug,ur,ur,ur,ub
ug,ur,ug,ug,ug,ug,ug,ur,ug,ug,ug,ur,ux,ur,ur,cg,ug,ug,ug,ur,ur,ur,ub
ug,ug,ug,ug,ug,ug,ug,ur,ur,ur,ur,ur,ub,ug,ux,ux,ux,ur,ur,ur,ur,ur,ub
cg,ug,ug,ug,ug,ug,ug,ub,ub,ux,ux,ux,ur,ur,ur,ur,ur,ur,ub,ub,ub,ub,ub
ux,ux,ux,ub,ux,ug,ug,ub,ub,ux,ux,ux,cb,ur,ur,ur,ub,ub,ub,ub,ux,ux,ux
ux,ux,ux,ub,ux,ug,ug,ub,ub,ur,ur,ub,ub,ub,ub,ur,cb,ur,cr,cr,ux,ux,ux
ux,ux,ux,ug,ug,ug,ug,ub,ub,ub,ub,ub,ug,ug,ug,ux,ux,ux,ux,ur,ux,ux,ux
ur,ur,ug,ug,ug,ug,ug,ug,ur,ur,ur,ur,cg,ur,ug,ur,ur,ub,ub,ur,ur,ur,ux
ub,ub,ug,ub,ug,ug,ug,ug,ug,ug,ug,ug,ug,ug,ug,ug,ur,ub,cb,ub,ux,ur,ux
ub,ux,ug,ux,ug,ug,ug,ug,ug,ug,ug,ug,ug,ug,ub,ug,ub,ub,ub,ub,ur,ur,cg
ub,ux,ug,ux,ug,ug,ug,ug,ug,ug,ux,ug,ug,ug,ug,ug,ub,ub,ub,ur,ur,ur,ur
ub,ur,ug,ur,ug,ug,ug,ug,ug,ug,ug,ug,ux,ux,ux,ux,ub,ub,ub,ur,ur,ur,ur
ub,ux,ug,ux,ur,ur,ur,ux,ux,ux,ux,ug,ux,ug,ug,ux,ub,ub,ub,ub,ub,ub,ub
ub,ux,ug,ux,ub,ur,ur,ur,ur,ur,ur,ur,ur,ur,ur,ur,ur,ur,ur,ur,ur,ur,ur
ub,ub,ug,ux,ub,cg,ux,ux,ux,ux,ux,ux,ux,ux,ux,ux,ur,ub,ub,ub,cr,ur,ur
cg,ub,ug,ux,ub,ug,ux,ux,ux,ux,ux,ux,ux,ux,ux,ux,ur,ur,ur,ur,ur,ur,ur
cb,ub,ug,ug,ug,ug,ub,ub,ub,ub,ub,cb,ur,ur,ur,ur,ur,ur,ur,ur,ur,ur,ur
ub,ub,ub,ux,ub,ur,ux,ux,ux,ux,ux,ux,cg,ux,ux,ux,ux,ux,ux,ux,ux,cr,ur
ub,ub,ub,ur,ur,ur,cr,ux,cr,ux,ux,cg,cb,ux,ux,ux,cr,ux,ux,cr,ux,cr,cb