ur,ur,cr,ur,ur,ug,ug,cb,cb,cb,cg,cg,cg,cr,ux,ub,ur,ur,ur,ur,cb,cb,cb
ur,ur,ur,ur,ur,cr,cg,ur,ur,ur,ur,ur,ur,ur,ub,ub,ur,ub,ur,ur,ur,ur,ur
ur,cr,ur,ur,ug,ur,ur,ur,ur,ur,ur,ur,ub,ub,ub,ub,ur,ur,ur,ur,ur,ur,ur
cb,ur,ur,cr,ug,ug,ug,ug,ur,ur,ur,ur,ub,ux,ux,ur,ur,ur,ur,ur,ur,ur,ur
ur,ur,ur,ug,cg,ug,ur,ug,ur,ur,ur,ur,ub,ux,ux,ux,ux,ux,ux,ux,ur,ur,ur
ur,ur,ur,ur,cr,ur,ur,ug,ux,ux,ur,ur,ub,ux,ux,ux,ux,ux,ux,ur,ur,ur,ur
ur,ur,ur,ur,ug,ur,ur,ub,ur,ur,ur,ur,cb,ur,ur,ur,ur,ur,ux,ur,ur,ur,ur
ur,ur,ur,ur,ug,ug,cg,ub,ub,ub,ub,ub,ub,ub,ub,ur,ux,ux,ux,ur,ur,ur,cr
ur,ur,ur,ur,ur,ub,ur,cg,ug,ug,ug,ur,ur,ur,cb,ur,ux,ub,ub,ub,ub,ub,ub
ur,ur,ur,ur,ur,ur,ur,ug,ug,ug,ur,ug,ur,ur,cg,ug,ug,ug,ug,ug,ug,ux,ub
ur,ur,ur,ur,ur,ur,ur,ug,ug,ug,ug,ug,ur,ub,cb,ub,ug,ug,ug,ug,ug,ub,ub
ur,ur,ur,ur,ur,ur,ur,ug,ug,ug,ug,ug,ur,ur,ur,ub,ur,ur,ur,ur,ur,ur,ur
ur,ur,ur,ur,ur,ur,ur,ur,ur,ur,ur,ur,ur,ux,ug,ub,ug,ug,ug,ug,ug,ug,ur
ur,ur,ur,ur,ur,ur,ur,ur,ur,ur,cb,ux,ur,ur,ug,ub,ug,ug,ug,ug,ug,ug,cr
ur,ur,ur,ur,ur,ur,ur,cb,ur,ur,ur,ur,ur,ur,ur,ub,ug,ug,ug,ug,ug,ux,ux
ux,ux,ux,ur,ur,cr,ur,ub,ux,ug,ug,ug,ux,ux,ux,ub,ub,ux,ux,ux,ug,ux,ux
ux,ur,ur,ur,ur,ur,ur,ub,ub,ub,ux,ug,ur,ur,ur,ur,ub,ur,ur,ur,ub,ur,ur
ux,ur,ur,ur,ur,ur,ur,ur,ur,ub,ub,ub,ub,ur,ub,ub,ub,ub,ub,ub,ub,ur,ux
ux,ux,ux,ux,ub,ub,ub,ub,ub,ub,ub,ug,ub,ub,ub,ub,ub,ub,ub,ub,ub,ux,cb
cg,ux,ux,ux,ub,ub,ub,ub,ub,ub,ux,ug,ub,ub,ux,ux,ux,ux,ux,ux,ub,ux,ux
cb,ux,ux,ux,ux,ux,ux,ux,ub,ub,ub,ub,ux,ux,ux,ux,ux,ub,ub,ub,ub,ux,ux
ux,ux,ux,ux,ux,ux,ux,ub,ub,ub,ub,ub,cg,ux,ux,ux,ux,ux,ux,ux,ux,cr,cb
cb,ux,ux,ux,ux,ux,cr,cb,cr,ub,ub,cg,cb,ux,ux,ux,cr,ux,ux,cr,ux,cr,cb