ur,ur,cr,cg,ug,ur,ur,cb,cb,cb,cg,ux,cg,ur,ur,ur,ur,ur,ur,cb,cb,ux,cb
ur,ur,ur,ur,ug,ug,ur,ur,ur,ur,cb,ur,ur,ur,ur,ur,ur,ur,ur,ur,ur,cb,cb
ur,ur,cr,cr,ug,ug,ur,ur,ur,ur,ub,ub,cr,ur,ur,ur,ur,ur,ur,ur,ur,ux,cr
cg,ur,cg,ur,ug,ug,ur,ur,ur,ub,ub,ub,ur,ur,ur,ur,ur,ur,ur,ur,ur,ur,ur
ur,ur,ug,ug,ug,ur,ur,ur,ug,ub,ur,ur,ur,ur,ur,ug,ug,ux,ux,ux,ux,ux,ux
ur,ur,ur,ug,ug,ug,ur,ur,ug,ub,cr,ur,ur,ur,ur,ub,ug,ux,ux,ux,ux,ux,ux
ux,ur,ug,ug,ur,cb,ur,ug,ux,ur,ug,ur,ug,ub,ur,ub,ug,ug,ux,ur,ur,ur,ur
ub,ub,ub,ub,ub,ub,ur,ur,ur,ur,ug,ur,ur,ub,cg,ug,ug,ug,ux,ur,ux,ux,ur
ub,ub,ub,ub,ub,ub,ub,ur,ur,ur,ur,ur,ur,ub,ur,ub,ub,ub,ub,ur,ur,ur,ur
ub,ub,ur,ux,ub,ub,ub,ur,ur,ur,ur,ur,ur,ub,ur,ub,ub,ur,ub,ur,ux,ux,ux
ub,ux,ur,ux,ub,ux,ux,ux,ux,ur,ur,ur,ur,ur,ur,ub,ub,ub,ub,ux,ux,ux,ux
ub,ux,ur,ub,ub,ux,ux,ug,ux,ub,ug,ug,ug,ub,ub,ub,ub,ub,ub,ub,ur,ur,ur
ub,ux,ur,ub,ux,ux,ux,ub,ub,ub,ub,ub,ug,ub,ub,ub,ub,ur,ub,ub,ur,ur,ur
ub,ux,ur,ub,ux,ux,ux,ub,ub,ub,ux,cg,ug,cb,ub,ub,ub,ur,ub,ub,ur,ur,cg
ub,ux,ur,ub,ux,ux,ub,ub,ub,ub,ug,ug,ub,ug,ug,ub,ub,ur,ub,ux,ur,ur,ub
ub,ux,ur,ub,ub,ub,ub,ug,ug,ux,ux,ug,ug,ug,ux,ux,ur,ur,ub,ux,ur,ur,cb
ub,ux,ur,ub,ub,ux,ux,ux,ux,ux,ux,ub,ux,ux,ux,ux,ur,ur,cb,ux,ur,ur,ur
ub,ux,ur,ub,ub,ub,ub,ub,ub,ub,ub,ub,ub,ub,ux,ux,ur,ur,ur,ux,ur,ur,ur
ub,ub,ur,ub,ub,ub,ub,ux,ux,ux,ux,ub,ub,ub,ub,ux,ur,ur,ur,cr,ur,ur,ur
cg,ub,ur,ub,ub,ux,ub,ub,ub,ub,ub,ub,ub,ub,ub,ux,ur,ur,ur,ur,ur,ur,ur
cb,ub,ur,ux,ub,cr,ux,ux,ux,ux,ux,ub,ub,ub,ub,ub,ur,ur,ur,ur,ur,ur,ur
ub,ub,ur,ur,ur,ur,ux,ux,ux,ux,ux,ux,cg,ub,ub,ub,ur,ur,ur,ur,ur,cr,ur
ub,ub,ub,ub,ub,ux,cr,ux,cr,ux,ux,cg,cb,ub,ub,ux,cr,ux,ux,cr,ur,cr,cb