ur,ur,cr,ur,ur,ur,ur,cb,cb,cb,cg,cg,cg,cb,ur,ur,ur,ur,ur,ur,cb,cb,cb
ur,ur,ur,ur,ur,ur,ur,cg,ur,ur,ur,ur,ur,ur,ur,ur,ur,ur,ur,ur,ur,ur,ur
ur,cr,ur,cg,ur,ur,ur,ur,ur,ur,ur,ur,ur,ur,ux,ur,ux,ur,ur,ux,ur,ux,ur
cb,ur,ug,ug,ur,ur,ur,ur,ur,ur,ur,ur,ur,ur,ux,ur,ur,ur,ux,ux,ur,ux,ur
ur,ug,ug,cr,ur,ur,ur,ur,ur,ur,ur,ur,ur,ur,cr,ur,ur,ur,ur,ux,ur,ux,ur
ur,cg,ug,cr,ur,ur,ur,ur,ur,ur,ur,ur,ur,ur,ur,ur,ur,ur,ur,ux,ur,ur,ur
ur,ur,ur,cr,ur,ur,ur,cg,ur,ux,ur,ur,ur,ur,ur,ur,ur,ur,ur,ur,ur,ur,ur
ur,ur,cr,ur,ur,ur,ur,ug,ur,ur,ur,ur,ur,ur,ur,ur,ur,ur,ur,ur,ub,cb,ur
ur,ur,ur,ur,ur,ur,ur,ug,ur,ur,ur,ur,ur,ur,ur,ur,ur,ur,ur,ur,ub,ub,ub
ur,ur,ur,ur,ur,ur,ur,cr,ur,ur,ur,ur,ur,ur,ur,ur,ur,ur,ur,ur,ub,ub,ub
ur,ur,ur,ur,ur,ur,ug,ur,ur,ur,ur,ur,ur,ur,ur,ur,ur,ug,ug,ur,ub,ub,ub
ur,ur,ur,ur,ur,ur,ug,ug,ug,ug,ug,ug,ug,ug,cg,ur,ur,ur,ug,ur,ux,ub,ux
ur,ur,ur,ur,ur,ur,ur,ur,ug,ub,ub,ub,ub,ub,ur,ug,ug,ur,ug,ur,ux,ux,ux
ur,ur,ur,ur,ur,ur,ur,ur,ug,ug,cb,ug,cb,ub,ur,ur,ur,ur,ub,ur,ux,ux,ux
ur,ur,ux,ux,ur,ur,ub,ug,ug,ug,ug,ug,ur,ug,ur,ur,ur,ur,ur,ur,ux,ux,ux
ux,ug,ux,ux,ur,ur,ux,ug,ux,ug,ug,ug,ur,ux,ur,ux,ux,ux,ux,ux,ux,ux,ux
ux,ug,ux,ux,ur,ur,ur,ug,ux,ug,ug,ug,ur,ux,ur,ur,ur,ur,ur,ur,ux,ux,ux
ux,ug,ug,ug,ur,ur,ur,ug,ug,ug,ug,ug,ur,ux,ux,ux,ux,ux,ux,ux,ux,ux,ux
ux,ux,ux,ux,ux,ux,ux,ux,ux,ux,ug,ug,ur,ux,ux,ux,ux,ux,ux,ux,ux,ux,cb
cg,ux,ux,ux,ux,ux,ux,ux,ux,ux,ux,ux,ur,ux,ux,cr,ur,ur,ur,ur,ur,ur,ur
cb,ux,ux,ux,ux,ux,ux,ux,ux,ux,ux,ux,ur,ur,ur,ur,ur,ur,ur,ur,ur,ur,ur
ux,ux,ux,ux,ux,ux,ux,ux,ux,ux,ux,ux,cg,ux,ux,ux,cb,ux,ux,ux,ux,cr,cb
cb,ux,ux,ux,ux,ux,cr,cb,cr,ux,ux,cg,cb,ux,ux,ux,cr,ux,ux,cr,ux,cr,cb