ur,ur,cr,ur,ur,ur,ur,cb,cb,cb,cg,ur,cg,ub,ub,cb,ub,ub,ur,cb,cb,ux,cb
ur,ur,ur,ur,cg,ur,ur,ur,ur,ur,cr,cr,ur,ur,ur,ur,ub,ub,ur,ub,ub,ub,cb
ur,ur,ur,ur,ug,ug,ur,ur,ur,ux,ux,ur,ur,ux,ux,ux,ub,ub,cr,ux,ux,ux,ux
cg,cr,ur,ur,ur,ug,ur,ur,ur,ur,ux,ur,ur,ub,ub,ub,cb,ur,ur,ur,ur,ur,ur
ur,ug,cr,ur,ur,ug,ur,ur,ur,ur,ux,ur,ur,ub,ux,ux,ub,ub,ux,ux,ux,ux,ur
ur,ug,ug,cg,ur,ug,ur,ur,ur,ur,ur,ur,ur,ub,ub,ub,ub,ub,ub,ub,ub,cr,ur
ur,ur,ur,ur,ur,ur,ur,ur,ur,ur,ur,ur,ub,ub,ub,ux,ux,ux,ux,ub,ub,ux,ub
ur,ur,ur,ur,ur,ub,ug,ug,ur,ur,ug,ug,ux,ur,ub,ux,ux,ux,ux,ub,ub,ub,ub
ur,ur,ur,ur,ur,ux,ux,ub,ug,ux,ux,ug,ug,ur,ug,ug,ug,ug,ug,ug,ub,ub,ub
ur,ur,ur,ur,ux,ux,ux,ub,ug,ux,ux,ug,ug,cg,ug,ug,ug,ug,ug,ug,ub,ux,ub
ug,ux,ux,ur,ux,ux,ux,ub,ug,ub,ub,ug,ug,ug,ug,ug,ug,ug,ug,ug,ub,ub,ub
ug,ux,ux,ur,cb,ub,ub,ub,ub,ub,ub,ug,ug,ug,ub,ug,ug,ug,ug,ug,ux,ub,ub
ug,ux,ux,ur,ur,ub,ux,ub,ub,ub,ub,ug,ub,ub,ub,cb,ug,ug,ug,ub,ub,ub,ub
ug,ux,ux,ur,ur,ub,ub,ub,ub,ub,ub,ug,ug,ug,ub,ub,cg,ug,ug,ub,ux,ux,cg
ug,ux,ux,ur,ur,ub,ub,ub,ub,ub,ub,ug,ug,ux,ur,ux,ux,ub,ub,cb,ub,ur,ur
ug,ux,ux,ur,ur,ub,ub,ux,ub,ub,ub,ug,ub,ub,ur,ub,ux,ux,ux,ux,ur,ux,ur
ug,ux,ux,ur,ur,ub,ub,ub,ub,ub,ub,ug,ux,ug,ug,ub,ux,ux,ux,ux,ur,ux,ur
ug,ug,ug,ur,ur,cr,ug,ug,ug,ub,ub,ug,ug,ug,ug,ub,ux,cb,ub,ub,ub,ub,ub
ux,ux,ug,ur,ur,ug,ub,ub,ug,ug,ug,ug,ug,ug,ug,ub,ux,ub,ub,ub,ub,ub,ub
cg,ux,ug,ux,ub,ug,ub,ub,ub,ub,ug,ug,ur,ug,ug,ub,ur,ub,ub,ub,ub,ub,ub
cb,ux,ug,ux,ux,ug,ub,ux,ux,ux,ux,ub,ub,ug,ug,ub,ub,ub,ub,ub,ub,ub,ub
ur,ur,ug,ug,ug,ug,ub,ub,ub,ub,ub,ub,cg,ub,ub,ub,ub,ux,ux,ux,ux,cr,ur
ur,ur,ur,ux,ux,ux,cr,ux,cr,ux,ux,cg,cb,ub,ub,ub,cr,ux,ux,cr,ux,cr,cb