ur,ur,cr,ur,ur,ur,ur,cb,cb,cb,ur,ur,cg,ur,ur,cb,ur,ur,ur,cb,cb,ux,cb
ur,ur,ur,ur,ur,cr,ur,cr,ur,ur,ur,ur,ur,ur,ur,ub,ub,ub,ur,ux,ux,ux,cb
ur,ur,ur,ur,cg,ug,ug,ur,ur,ur,ur,ur,ur,ur,ur,ur,ur,cr,ur,ur,ux,ux,ux
ur,ur,ur,ur,ur,ug,ug,ub,ur,ur,ur,ur,ur,ur,ur,ur,ur,ur,ur,ub,ux,ux,ux
ur,ur,ur,ur,ur,cr,ug,ub,ub,cb,ug,ur,ur,ur,ub,ub,cb,ur,ub,ux,ux,ux,ux
ux,ug,ug,ug,ug,ug,ur,ur,ux,ur,ug,cg,ur,ur,ub,ur,ub,ub,ub,ub,ub,ub,ux
cb,ux,ux,ug,ug,ux,ur,ur,ur,ur,ur,ur,cr,ub,ub,ug,ug,ub,ux,ux,ux,ub,ux
ub,ux,ux,ux,ug,ur,ur,ug,ug,ug,ug,ub,ub,ub,ub,ub,ux,ux,ur,ur,ur,ur,ux
ub,ux,ux,ux,ug,ug,ug,ug,ur,ub,ub,ub,ub,ux,ub,ug,ug,ug,ug,ug,ug,ur,ux
ub,ux,ux,ux,ux,ux,ur,ur,ub,ub,ub,ub,ub,ub,ub,cg,ux,ug,ug,ug,ug,ur,ux
ub,ux,ux,ux,ux,ux,ug,ug,ub,ub,cb,ur,ub,ub,ux,ug,ug,ug,ug,ug,ug,ur,ux
ub,ub,ub,ub,ub,ub,ub,ug,ub,ub,ub,ub,ub,ug,ux,ug,ug,ug,ug,ug,ug,ux,ux
ub,ub,ub,ub,ub,ub,ub,ug,ub,ub,ub,ug,ux,ug,ug,ug,ug,ug,ug,ug,ug,ux,ux
ub,ux,ux,ux,ug,ug,ug,ug,ug,ug,ux,ug,ug,ug,ux,ur,ug,ug,ug,ug,ur,ur,cg
ub,ur,ux,ux,ug,ug,ug,ub,ub,ub,ub,ux,ux,ux,ux,ur,ur,ur,ux,ux,ux,ur,cr
ub,ur,ur,ur,ug,ug,ug,ug,ur,cb,ub,ug,ug,ug,ug,ug,ug,ug,ur,ur,ur,ur,ur
ub,ur,ur,ub,ub,ub,ub,ug,ux,ux,ub,ug,ug,ug,ug,ug,ug,ug,ur,ur,ur,ur,ur
ub,ub,ux,ub,ug,ux,ub,ub,ug,ug,ub,ug,ug,ug,ug,ug,ug,ug,ug,ub,ub,ur,ur
cg,ub,ux,ub,ug,ug,ug,ub,ub,ub,ub,ur,ub,ub,ub,ub,ub,ux,cg,ub,ub,ur,ur
cg,ub,ux,ub,ug,ug,ug,ux,ub,ub,ub,ur,ub,ub,ub,ub,ux,ux,ux,ub,ub,ur,ur
cb,ub,ux,ub,ux,ur,ur,ur,ur,ur,ub,ub,ub,ub,ur,ur,ur,ur,ur,ur,ur,ur,ur
ub,ub,ux,ub,ux,ur,ur,ur,ur,ur,ur,ur,cg,ur,ur,ur,ur,ur,ur,ur,ur,cr,ux
ub,ub,ub,ub,ur,ur,cr,ux,cr,ux,ux,cg,cb,cr,ub,ux,cr,ux,ux,cr,ur,cr,cb