ur,ug,ug,ug,ug,ug,ur,cb,cb,cb,cb,cg,cg,cb,ug,ug,ug,ur,ur,ub,cb,cb,cb
ur,ug,ug,ug,ug,ug,ur,ug,ug,ug,ug,ug,ug,ug,ug,ur,ug,ug,ug,ub,ub,ub,cg
ur,ug,ug,ug,ug,ug,ur,ug,ug,ug,ub,ur,ub,cg,ug,ug,ug,ur,ug,ug,ug,ur,ur
ur,ug,ux,ug,ug,ug,ur,ug,ug,ug,ug,ug,ub,ur,ur,ub,ug,ur,ur,ub,ug,ub,ur
ur,ug,ug,ug,ug,ug,ug,ug,ug,ug,ug,ug,ug,ug,ug,ug,ug,ug,ur,ur,ug,ur,ur
ur,ug,ug,ug,ug,ug,ug,ug,ug,ug,ug,ug,ug,ug,ug,ug,ug,ug,ug,ug,ug,ur,ug
ur,ug,ug,ug,ug,ur,ur,ur,ug,ug,ug,ug,ug,ug,ug,ug,ug,ug,ur,ur,ub,ur,ug
ur,ug,ug,ur,ug,ug,ur,ug,ug,ug,ub,ur,ur,ur,ur,ug,ug,ur,ub,ur,ug,ur,ug
ur,ug,ug,ur,ug,ug,ur,ug,ug,ug,ug,ug,ug,ug,ug,ug,cg,ug,ug,ug,ur,ur,ur
ur,ug,ug,ur,ug,ug,ur,ug,ug,ug,ug,ug,ug,ug,ug,ug,ug,ug,ug,ur,ur,ur,ur
ur,ug,ug,ur,ur,ur,ur,ur,ug,ug,ug,ur,ur,ug,ug,ug,ug,ug,ug,ur,ur,cg,ur
ur,ur,ur,ur,ur,ur,ur,ur,ur,ur,ug,ur,ug,ug,ug,ug,ug,ug,ug,ur,ug,ug,ur
ur,ur,ug,ur,ug,ur,ur,ur,ur,ur,ug,ur,ug,ug,ur,ug,ug,ug,ur,ur,ur,ug,ur
ur,ur,ug,ur,ug,ur,ur,ug,ur,ug,ug,ur,ug,ug,ug,ug,ug,ug,ug,ug,ub,ug,ub
ur,ur,ub,ur,ug,ur,ur,ub,ur,ur,ug,ur,ug,ug,ug,ug,ug,ug,ug,ub,ub,ug,cr
ur,ur,ub,ur,ub,ur,ur,ub,ub,ub,ug,ug,ug,ug,ug,cg,ug,ub,ub,ub,ub,ug,ur
ur,ur,ur,ur,ur,ur,ur,ur,ur,ur,ub,ug,ug,ur,ub,ug,ug,ug,ug,cb,ub,ug,ur
ur,ug,ug,ur,ur,cr,ur,ur,ur,ub,ub,ug,ur,ur,ur,ur,ur,ur,ur,ub,ur,ur,ur
ur,ug,ug,ug,ug,ug,ug,ug,ur,ug,ub,ug,ug,ub,ug,ug,ub,ub,ub,ub,ub,ub,ur
cr,ug,cg,ur,cr,ug,ur,ug,ur,ug,ub,ur,ug,ug,ug,ug,ur,ur,ub,ub,ub,ur,ur
cb,ug,ur,ur,ur,ug,ur,ur,ur,ug,ur,ur,ug,ur,ug,ug,ug,ug,cb,ub,ub,ur,ur
ub,ug,ur,ur,ur,ug,ur,ur,ug,ug,ur,ur,cg,ug,ur,ur,ug,ug,ug,ub,ub,cr,cb
cb,ur,ur,ur,ur,ur,ur,ug,ug,ug,ur,cg,cb,ug,ug,ug,ug,cb,ug,cr,cb,cr,cb