ux,ur,cr,ur,ur,ur,ux,cb,cb,cb,cg,cr,cg,ur,ur,cb,ur,ur,ur,cb,cb,ur,cb
ur,ur,ur,ur,ur,ur,ur,ur,ur,ur,ur,ur,ub,ur,ur,ur,ur,ur,ur,ur,ur,ur,cb
ur,ur,ur,ur,ur,ur,ur,ub,cb,ur,ur,cb,ub,ur,ur,ur,ug,ur,ur,ur,ur,ur,ux
ur,ur,ur,ug,ug,cg,ur,ub,ur,ur,ur,ur,ur,ur,ur,ur,ug,ur,ub,cb,ub,ub,ux
ur,ug,cr,ug,ug,ur,ug,ub,ur,ur,ur,ur,ug,ug,cr,ug,ur,ur,ub,ur,ub,ub,ur
ur,ur,ur,ur,ur,cr,cr,ur,ur,ub,ur,ur,cg,ug,ug,ug,cg,ub,ub,ub,ub,ub,ub
ur,ur,ur,ur,ur,ur,ug,ug,ug,ub,ub,ug,ur,ug,ug,ux,ux,ub,ub,ub,ub,ub,ub
ur,ur,ur,ur,ur,ur,ug,ur,ur,ub,ur,ur,ur,ug,ug,ux,ux,cb,ub,ub,ub,ub,ub
ur,ur,ur,ur,ur,ur,ug,ur,ur,ub,ur,ux,ug,ug,ug,ux,ux,ub,ub,ub,ub,ub,ub
ur,ur,ur,ur,ur,ur,ug,ub,ub,ug,ur,ug,ug,ub,ux,ux,ub,ug,ub,ub,ub,ub,ub
ur,ur,ur,ur,ur,ur,ub,ub,ub,ub,ur,ux,ug,ug,ub,ub,ug,ug,ub,ub,ub,ub,ub
ur,ur,ux,ux,ux,ug,ux,ug,ug,ub,ub,ub,cb,ug,ub,ub,ub,ub,ub,ub,ub,ub,ub
ux,ux,ux,ug,ug,ug,cg,ug,ug,ug,ub,ub,ub,ug,ug,cr,ur,ur,ub,ub,ub,ub,ub
ux,ux,ux,ug,ug,ux,ug,ug,ug,ug,ur,ug,ub,ub,ux,ug,ub,ur,ub,ur,ur,ux,cg
ux,ux,ux,ug,ug,ug,ug,ug,ug,ub,ur,ub,ub,ug,ur,ur,ur,ur,ub,ub,ub,ub,ux
ux,ux,ux,ux,ux,ug,ub,ub,ub,ub,ur,ur,ur,ur,ur,ux,ux,ug,ux,ux,ux,ub,ub
ur,ur,ur,ur,ur,ub,ub,ub,ub,ub,ub,ub,ub,ub,ub,ub,ub,ug,ub,ub,ub,ub,ub
ur,ur,ur,ur,ur,ur,ur,ur,ur,ur,ur,ur,ug,ug,ug,ug,ug,ug,ur,ur,ur,ur,ur
cg,ux,ux,ux,ux,ux,ux,ux,ux,ux,ux,ux,ux,ub,ub,ub,ub,ub,ub,ub,ub,ub,ur
cg,ux,ux,ux,ux,ux,ux,ux,ux,ux,ux,ux,ux,ub,ux,ux,ux,ux,ux,ux,ux,ux,ur
cb,ur,ur,ur,ur,ur,ur,ur,ur,ur,ur,ur,ur,ur,ur,ur,ur,ur,ur,ur,ur,ur,ur
ux,cr,ux,ux,ux,ux,ux,ux,ux,ux,ux,ux,cg,ub,ub,ux,ux,ux,ux,ux,ux,cr,ur
ux,ux,ux,ux,ux,ux,cr,ux,cr,ux,ux,cg,cb,ub,ub,ux,cr,ux,ux,cr,ux,cr,cb