cg,ug,cr,ur,ur,ur,ur,cb,cb,cb,ur,cg,cg,ur,ur,ur,ur,ur,ux,ux,cb,cb,cb
cr,ur,ur,ur,ur,ur,ur,ur,ur,ur,ur,ur,ur,ur,ur,ur,ur,ur,cr,ug,ug,ur,cb
ug,cr,ur,ur,ur,ur,ur,ur,ur,ur,cr,ur,ur,ur,ug,ug,ur,ur,cb,ub,cg,ur,ur
ug,ug,ur,ur,ur,ur,ur,ur,ur,ug,ug,ur,ur,ur,ur,ur,ug,ub,ub,ub,ur,ux,ur
ux,ux,ur,cr,ux,ux,ur,ur,ux,ug,ux,ur,ur,ur,ur,ux,ug,ub,ug,ux,ur,ux,ur
cb,ux,ur,ug,ux,ux,ug,ur,ug,ug,ux,ug,ug,ug,ub,ub,ub,ug,ug,ux,ur,ux,ur
ux,ux,ux,ug,ux,ux,ux,ur,ur,ub,ub,ub,cb,ug,ub,ug,ug,ug,ux,ux,ur,ux,ur
ux,ux,ux,ug,ux,ux,ux,ux,ug,cg,ux,ux,ux,ux,ub,cg,ug,ug,ux,ux,cr,ux,ur
ux,ux,ux,ug,ux,ux,ux,ux,ug,ub,ub,ub,ub,ub,ub,ub,ux,ux,ux,ux,ux,ux,ur
ux,ux,ux,ug,ux,ux,ux,ux,ug,ux,ub,ub,ub,ub,ub,ub,ur,ur,ur,ux,ux,ux,ur
ux,ux,ux,ux,ux,ux,ux,ux,ug,cb,ub,ub,ub,ub,ub,ub,ux,ux,ur,ux,ux,ux,ur
ux,ux,ux,ux,ux,ux,ux,ux,ux,ux,ug,ub,ub,ub,ub,ub,ux,ux,ur,ux,ux,ux,ur
ub,ux,ux,ux,ux,ux,ux,cr,ur,ur,cb,ub,ub,ub,ub,ub,ub,ux,ur,ux,ux,ux,ur
cb,ub,ub,ub,ux,ux,ux,ux,ux,ux,ug,ux,ub,ub,ub,ub,ub,ux,ur,ux,ux,ux,ur
ub,ub,ub,ub,ub,ux,ux,ug,ug,ug,ug,ur,ub,ub,ux,ux,ux,ux,cg,ug,ug,ux,ux
ux,ux,ux,ub,ub,ux,ux,ug,ug,ux,ug,ur,ux,ub,ub,ub,ur,ux,ur,ux,ug,ub,ub
ux,ux,ux,ux,ux,ux,ux,ux,ug,ug,ug,ux,ux,ur,ur,ur,ug,ug,ug,ug,ug,ub,ub
ux,ux,ux,ux,ux,ux,ux,ur,ug,ug,ux,ux,ux,ux,ux,ur,ug,ur,ug,ub,ub,ux,ux
ux,ux,ux,ux,ux,ux,ux,ux,ug,ux,ux,ux,ux,ux,ug,ug,ug,ub,ug,ub,ub,ub,ux
cg,ux,ux,ux,ux,ux,ux,ux,ux,ux,ux,ux,ux,ux,ug,ug,ug,ug,ub,ub,ub,ux,ux
cb,ux,ux,ux,ux,ux,ux,ux,ux,ux,ux,ux,ux,ux,ux,ux,ux,ug,ub,ub,cb,ub,ux
ux,ux,ux,ux,ux,ux,ux,ux,ux,ux,ux,ux,cg,ux,ux,ux,ux,ux,ux,ub,ub,cr,cb
cb,ux,cg,ux,ux,ux,cr,cb,cr,ux,ux,cg,cb,ux,ux,ux,ux,ux,ux,cr,ur,cr,cb