ur,ur,cr,ur,ur,ur,ur,cb,cb,cb,cg,ur,cg,ur,ur,ur,ur,ur,ur,cb,cb,ux,cb
ur,ur,ur,cr,ug,ug,ur,ur,ur,ur,ur,ur,ur,ur,ur,ur,ur,ur,ur,ur,ur,cb,cb
ur,ur,ur,ur,cg,ug,ur,ur,ur,ur,ur,ur,ur,ur,ur,ur,ur,ur,ur,ur,ur,ur,ur
cg,ur,ur,ur,ur,ur,ur,ur,ur,ur,ur,ur,ur,ur,ur,ur,ur,ur,ur,ur,ur,ur,ur
ur,ur,ur,ur,cr,ur,ur,ur,ur,ur,ux,ux,cr,ux,ur,ur,ur,ur,ur,ur,ur,ur,ur
ur,ur,ur,ur,ur,ur,ur,ur,ur,ur,ur,ur,ur,ur,ur,ur,ur,ur,ur,ur,ur,ur,ur
ur,ur,cg,ug,ug,cr,ur,ur,ur,ur,ur,ur,ur,ur,ur,ur,ur,ur,ur,ur,ub,ur,ux
ur,ur,ur,ur,ur,ur,ur,ur,ur,ur,ug,ug,ux,ux,ur,ur,ug,ur,ur,ur,ur,ur,ub
ur,ur,ur,ur,ur,ur,ur,ur,ur,cr,ux,ux,ux,ux,ux,ur,ug,ug,ug,ub,ub,ub,ub
ur,ur,ur,ur,ur,ur,ur,ur,ur,ub,ub,ub,ub,ux,ux,ur,ug,ug,ug,ub,ub,ub,ub
ur,ur,ux,ux,ur,ur,ur,ug,ub,ub,ub,ub,cb,cb,ug,cg,ub,ub,ub,ub,ub,ub,ub
ur,ur,ur,ur,ur,ur,ur,ub,ub,ub,ub,ub,ub,ub,ur,ub,ur,ur,ub,ur,ur,ur,ur
ur,ur,ur,ur,ur,ur,ur,ub,ub,cr,ur,cb,ub,ub,ub,ub,ur,ur,ur,ur,ur,ur,ur
ur,ur,ux,ux,ux,ux,ux,ub,ug,ug,ub,ub,ug,ug,ug,ur,ur,ub,ub,ub,ub,ur,cg
ux,ux,ux,ux,ux,ux,ux,ux,ug,ug,ug,ub,ug,ub,ug,ug,ur,ub,ub,ub,ub,ub,ub
ux,ux,ug,ug,ug,ug,ug,ug,ug,ur,ub,ub,ub,ub,ub,ux,ur,ux,ub,ub,ub,ub,cb
ur,ur,ug,ux,ux,ux,ux,ub,ub,ub,ub,ub,ub,ub,ub,ux,cr,ux,ub,ub,ub,ub,ub
ur,ur,ug,ug,ug,ug,ug,cg,ur,ur,ur,ub,ub,ub,ub,ub,ub,ux,ub,ub,ub,ur,ub
ux,ux,ux,ux,ux,ux,ux,ux,ux,ux,ux,ub,ux,ub,ux,ub,ub,ub,ub,ub,ub,ub,cb
cg,ux,ux,ux,ux,ux,ux,ux,ux,ux,ux,ub,ux,ub,ug,ub,ub,ub,ub,ub,ub,ub,ub
cb,ur,ur,ur,ur,ur,ur,ur,ur,ur,ur,ub,ub,ub,cb,ub,ug,ub,ub,ub,ub,ub,ub
ux,ur,ux,ux,ux,ur,ur,ur,ur,ur,ur,ur,cg,ub,ub,ub,ub,ub,ub,ux,ux,cr,ur
ux,ur,ur,ur,ur,ur,cr,ux,cr,ux,ux,cg,cb,ub,ub,ux,cr,ux,ux,cr,ux,cr,cb