cr,ux,cr,ur,ur,ur,ur,cb,cb,cb,cg,cg,cg,ur,ur,ux,ux,ux,ux,ux,cb,cb,cb
cg,ux,ux,ur,ur,ur,ur,ur,ur,ur,ur,ur,ur,ur,ur,ux,ux,ux,ux,ux,ux,ux,ux
ur,cr,ur,ur,ur,ur,ur,ur,ur,ur,ur,ur,ur,ur,ur,ur,ur,ur,ux,ux,ux,ux,ux
ur,ur,ur,ur,ur,cr,cr,ur,ur,ur,ur,ur,ur,ur,ur,ux,ux,ur,ur,ux,ux,ux,ux
ur,ur,ur,ur,ur,ub,cb,ur,ur,ur,ur,ur,ur,ur,cr,ug,ug,ug,ur,ux,ux,ux,ux
ur,ur,ur,ur,cg,ux,ub,cr,ur,ur,ux,ur,ux,ux,ux,ug,ug,ug,ug,ux,ux,ux,ux
ux,ur,ur,ux,ug,ux,ug,ux,ub,ux,ux,ur,ux,ux,ux,ug,ug,ug,ux,ur,ur,ur,ur
ux,ur,ur,ux,ug,ug,ug,ux,ub,ux,ur,ur,ux,ux,ux,ug,ug,ug,ug,ug,ux,ux,ur
ur,ur,ur,ur,ur,ur,ur,ur,cb,ur,ur,ux,ux,ux,ux,ug,ug,cg,ux,ug,ux,ug,ur
ur,ur,ur,ur,ur,ur,cr,ux,ug,ux,ux,ux,ux,ux,ux,ug,ug,ux,ux,ug,ux,ug,ur
ur,ur,ub,ux,ux,ux,ux,ux,ug,ub,ub,ug,ug,ub,ux,ug,ug,ug,ug,ug,ug,ug,ur
ux,ux,ub,ux,ux,ux,ux,ux,ug,ub,ub,ub,ub,ub,ub,ub,ub,cg,ug,ug,ug,ug,ur
ub,ub,ub,ub,ug,ug,ug,ug,ug,cb,ub,ub,ub,ub,ub,ux,ub,ub,ub,cb,ux,ux,ur
ux,ux,ux,ux,ug,cg,ux,ux,ub,ux,cb,ux,ub,ub,ub,ub,ub,ub,ub,ub,ux,ux,ur
ux,ux,ux,ux,cb,ub,ub,ux,ub,ux,ug,ug,ub,ub,ux,ux,ub,ub,ux,ub,ux,ux,ur
ux,ux,ux,ux,ug,ug,ub,ug,ub,ux,ug,ux,ub,ub,ux,ux,ux,ux,ux,ub,ub,ub,ur
ux,ux,ux,ux,ug,ug,ub,ux,ub,ux,ug,ug,ug,ug,ux,ux,ux,ux,ux,ub,ub,ux,cr
ux,ux,ux,ux,ux,ug,ub,ub,ub,ux,ug,ug,ux,ur,ur,ur,ur,ur,ur,ur,ub,ub,ub
ux,ux,ux,ux,ux,ug,ug,ug,ug,ug,ux,ux,ux,ux,ux,ux,ux,ux,ux,ux,ux,ux,cb
cg,ux,ux,ux,ux,ux,ux,ux,cr,ur,ur,ur,ur,ur,ur,ur,ur,ur,ur,ur,ur,ur,ur
cb,ux,ux,ux,ux,ux,ux,ur,ur,ur,ur,ur,ur,ur,ur,ur,ur,ur,ur,ur,ur,ur,ur
ux,ux,ux,ux,ux,ux,ux,ux,ux,ux,ux,ux,cg,ux,ux,ux,ux,ux,ux,ux,ux,cr,cb
cb,ux,ux,ux,ux,ux,cr,cb,cr,ux,ux,cg,cb,ux,ux,ux,ux,ux,ux,cr,ux,cr,cb