ur,ur,cr,ur,ur,ur,ur,cb,cb,cb,cg,ur,cg,ur,ur,ur,ur,ur,ux,cb,cb,ux,cb
ur,ur,ur,ur,ur,ur,ur,ur,ur,ur,ur,cr,ub,ub,ur,ur,ur,ur,ur,ub,cb,ub,cb
ur,ur,cr,ug,ur,ur,ur,ur,ur,ur,ur,ur,ub,ub,ur,ur,ur,ur,ur,ub,ub,ub,ur
cg,ur,ur,ug,ug,ur,ur,ur,ur,ur,ur,ur,ug,ug,ug,ub,ub,ur,ur,ur,ur,ur,ur
ur,ur,ur,cg,ug,ug,ur,ur,cr,ug,ur,ub,ub,ug,ug,ur,ug,ub,ur,ur,ur,ur,ur
ug,ug,ug,ug,ur,cg,ur,ur,ur,ur,ur,ub,ux,ug,ug,ug,ug,ub,ub,cr,ur,ur,ur
ug,ug,ug,ug,ug,ug,ug,ub,ub,ub,ub,ub,ux,ux,ug,ux,ux,ux,ub,ub,ub,ur,ur
ur,ur,cr,ur,ur,ux,cb,ub,ub,ub,ub,ub,ub,ub,cg,ur,ur,ur,ur,ur,ur,ur,ur
ur,ur,ur,ur,ux,ux,ur,ub,ub,ub,ub,ux,ux,ux,ux,ub,ub,ub,ub,ub,ub,ux,ur
ur,ur,ur,ur,ux,ux,ur,ug,ug,ug,ub,ux,ux,ux,cb,ub,ub,ub,ub,ub,ub,ux,ur
ub,ub,ub,ub,ub,ub,ur,ub,ub,ub,ub,ub,ub,ub,ux,ux,ug,ug,ub,ub,ub,ux,ur
ub,ub,ub,ub,cb,ug,ug,ug,ug,ug,ug,ug,ug,ug,ur,ug,cg,ub,ub,ub,ub,ux,cr
ub,ux,ub,ub,ub,ug,ur,ub,ub,ub,cg,ug,ug,ug,ug,ug,ug,ur,ub,ug,ub,ux,ub
ub,ux,ub,ub,ub,ug,ur,ur,ur,ub,ug,ug,ug,ug,ug,ug,ug,ur,ub,ug,ub,ux,ub
ub,ux,ub,ub,ub,ug,ug,ub,ub,ur,ub,ug,ug,ug,ug,ug,ug,ur,ub,ux,ub,ux,ub
ub,ux,ub,ub,ub,ur,ur,ur,ur,ur,ub,ug,ug,ub,ug,ug,ug,ur,ub,ux,ub,ux,cb
ub,ub,ub,ub,ub,ug,ug,ux,ux,ux,ux,ux,ug,ub,ug,ug,ug,ug,ub,ux,ub,ux,ur
ub,ub,ub,ub,ub,ux,ux,ux,ux,ux,ux,ux,ux,ub,ux,ux,ux,cr,ur,ur,ur,ur,ur
ub,ub,ub,ux,ub,ux,ux,ux,ux,ux,ux,ux,ux,ub,ux,ux,ux,ub,ub,ub,ub,ub,cb
cg,ux,cb,ux,ub,ux,ux,ux,ux,ux,ux,ux,ux,ub,ux,ux,ux,ub,ub,ub,ub,ub,ub
cb,ux,ux,ux,ub,ub,ub,ub,ub,ub,ub,ub,ub,ub,ux,ux,ux,ur,ur,ux,ub,ub,ub
ux,ux,ux,ux,ux,ux,ux,ux,ux,ux,ux,ux,cg,ux,ux,ux,ux,ur,ur,ux,ux,cr,ux
ux,ux,ux,ux,ux,ux,cr,ux,cr,ux,ux,cg,cb,ux,ux,ux,cr,ur,ur,cr,ux,cr,cb