ur,ur,cr,ur,ur,ur,ur,cb,cb,cb,cg,cg,cg,cb,ur,ur,ur,ur,ur,ur,cb,cb,cb
ur,ur,ur,ur,ur,ur,ur,cg,ur,ub,ur,ur,ur,ur,ur,ur,ur,ur,cr,cr,ug,ur,cb
ur,cr,ur,ur,ur,ur,ur,ur,ur,ur,ur,ur,ur,ur,ur,ur,ur,ur,ur,ur,ug,ur,ur
ur,ur,ur,ur,ur,ur,ur,ur,ur,ur,ur,ur,cr,ur,ur,ur,ur,ur,ur,cg,ug,ur,ur
ur,ur,ur,ur,ur,ur,ur,cg,ug,ug,ug,ur,cr,ur,ur,ur,ur,ur,ur,ur,ur,ur,ur
ur,ur,ur,ur,ur,ur,ur,ug,ug,ug,ug,ur,ug,ug,ug,ur,ur,ur,ur,ur,ur,ur,ur
ur,ur,ur,ur,cr,ug,ur,ur,ur,ur,ur,ur,ur,ur,ug,ux,ur,ur,ur,ug,ux,ug,ux
ux,ur,ux,ur,ux,ur,ur,ur,ur,ur,ur,ur,ur,ur,ug,ux,ux,cr,ur,ux,ux,ug,ux
ur,ur,ur,ur,ur,ur,cb,ub,ub,ub,ub,ur,ur,ur,cg,ub,ub,ub,ub,ux,ux,ug,ux
ur,ur,ur,ur,ur,ur,ur,ub,ub,ur,ur,ug,ur,ur,ug,ug,ur,ub,ub,ug,ug,cb,ub
ur,ur,ur,ur,ur,ur,ur,ur,ub,ur,ur,cr,ur,ur,ug,ug,ug,ug,ub,ub,ux,ub,ub
ur,ur,ur,ur,ug,ug,ug,ug,ug,ug,cg,ub,ug,ug,ug,ub,ub,ug,ub,ub,ub,ub,ub
ur,ur,ur,ur,ug,ub,ug,ug,ug,cb,ub,ub,ub,ub,ub,ub,ug,ug,ub,ub,ux,ux,ux
ux,ur,ub,ub,ug,ug,ug,ug,ug,ur,cb,ub,ux,ur,ug,ug,ug,ug,ub,ub,ux,ux,ux
ux,ux,ub,ur,ux,ub,ug,ug,ub,ur,ub,ub,ug,ug,ug,ug,ug,ux,ub,ub,ux,ux,ux
ux,ux,ub,ur,ur,ub,ur,ux,ub,ur,ur,ur,ur,ur,ur,ur,ur,ur,ur,ub,ux,ux,ux
ux,ux,ub,ub,ub,ub,ux,ux,ux,ur,ur,ub,ub,ub,ur,ux,ux,ur,ur,ub,ux,ux,ux
ux,ux,ub,ux,ux,ux,ux,ux,ux,ur,ur,ub,ub,ub,ug,ug,ug,ur,ur,ub,ub,ub,ub
ub,ub,ub,ux,ux,ux,ux,ux,ux,ur,ur,ux,ug,ur,ur,ux,ux,ur,ur,ub,ub,ub,cb
cg,ux,ux,ux,ux,ux,ux,ux,ux,ur,ur,ux,ug,ug,ug,ug,ug,ur,ur,ub,ub,ub,ux
cb,ux,ux,ux,ux,ux,ux,ux,ux,ur,ur,ux,ux,ux,ux,ux,ux,ur,ur,ux,ux,ux,ux
ux,ux,ux,ux,ux,ux,ux,ux,ux,ur,ur,ux,cg,ux,ux,ux,cb,ur,ur,ux,ux,cr,cb
cb,ux,ux,ux,ux,ux,cr,cb,cr,ur,ur,cg,cb,ux,ux,ux,cr,ur,ur,cr,ux,cr,cb