ur,ur,cr,ur,ur,ur,ur,cb,cb,cb,cg,ur,cg,ub,ub,cb,ur,ur,ur,ur,cb,cb,cb
ur,cg,ur,ur,ur,ur,ur,ur,ur,ur,ur,ur,ur,cr,ur,ur,ur,ur,ur,ur,ur,ub,ub
ur,ug,cr,ur,ug,ug,ur,ur,ur,ur,ur,ur,ur,ur,ur,ur,ur,ur,ur,ur,ur,ub,ub
cb,ur,ur,ur,ug,ug,ur,ur,ur,ur,ur,ur,ur,ug,cr,ug,cg,ur,ur,ur,ur,ur,ur
ur,ur,ug,ug,ug,ug,ug,ur,ur,ur,ur,ur,ur,ug,ub,ub,ub,ur,ur,ur,ur,ur,ur
ug,cr,ug,ug,ug,ug,ug,ug,ur,ur,ur,ur,ur,cr,ub,ur,cb,ur,ur,ur,ur,ur,ur
ug,ug,ug,ug,ug,ug,ug,ug,ur,ur,ur,ur,ur,ur,ur,ur,ur,ux,ur,ur,ub,ur,ur
ur,ux,ug,ug,ug,ug,ug,ug,cg,ur,ur,ur,ur,ur,ur,ur,ur,ur,ur,cr,ub,ur,ur
ur,ur,ur,ur,ug,ug,ug,ug,ub,ub,ub,ub,ub,ub,ub,ug,ub,ug,ub,ub,ub,ux,ux
ux,ux,ux,ux,ug,ug,ug,ug,ug,ub,ug,ub,ub,ub,ub,ub,ur,ug,ur,ux,ux,ux,ux
ux,ux,ux,ux,ug,ug,ub,ug,ug,ub,ub,cb,ub,ub,ub,ub,ub,ug,ub,ux,ur,ur,ur
ux,ux,ux,ux,ug,ug,ug,ug,ug,ub,ub,ub,ub,ub,ub,ub,ub,ug,ub,ux,ux,ux,ur
ux,ux,ux,ux,ug,ug,ug,ug,ux,ux,ug,ux,ub,ub,ub,ug,ug,ub,ub,ux,ux,ux,ur
ur,ur,ur,ur,ug,cg,ug,ug,ur,ur,ug,ug,ur,ur,ur,ug,ur,ur,ur,ur,ur,ur,ur
ur,ub,ux,ux,ub,ub,ux,ug,ug,ug,cg,ug,ub,ub,ug,ug,ub,ub,ub,ug,ur,ur,ux
ur,ub,ug,ug,ub,ub,ub,ub,ub,ux,ug,ub,ub,ub,ub,ub,ub,cb,ug,ug,ur,ug,ug
ur,ub,ux,ux,ub,ub,ub,ub,ub,ux,ug,ub,ub,ub,ub,ub,ub,ub,ug,ug,ur,ur,ug
ur,ub,ub,ub,ub,ux,ux,ub,ub,ux,ug,ub,ug,ug,ub,ub,ub,ub,ur,ub,ur,ug,ug
ur,ur,ur,ur,ur,cr,ux,ux,ub,ub,ug,ub,ub,ub,ub,ub,ub,ub,ur,ux,ur,ur,cb
cg,ux,ux,ux,ux,ux,ux,ux,ux,ub,ub,ub,ub,ub,ux,ux,ug,ur,ur,ur,ur,ux,ux
cb,ux,ux,ux,ux,ux,ux,ux,ux,ub,ub,ux,ub,ub,ux,ux,ux,ur,ur,ur,ur,ux,ux
ux,ux,ux,ux,ux,ub,ub,ub,ub,ub,ub,ux,cg,ux,ux,ux,ux,ur,ur,ur,ur,cr,ub
ux,ux,ux,ux,ux,cb,cr,ux,cr,ub,cb,cg,cb,ux,ux,ux,cr,ur,ur,cr,ur,cr,cb