ur,ur,cr,ub,cb,ur,ur,cb,cb,cb,cg,ux,cg,ur,ur,ur,ur,ur,ur,cb,cb,ub,cb
ur,ur,ur,cg,ug,ur,ur,ur,ur,cr,ux,ub,ub,ub,ub,ub,ub,ub,ub,ub,ub,ub,ub
ur,ur,ur,cr,cr,ur,ur,ur,ub,ux,ux,ub,ux,ux,ur,ur,ur,ur,ur,ur,ub,ub,ub
ur,ur,ur,ur,ur,ur,ur,ub,ub,ub,ub,ub,ux,ur,ur,ur,ur,ux,ux,ux,ur,ur,cb
ur,ug,ug,ug,ug,cr,ub,ub,ug,ub,ub,ub,ug,ur,ur,ur,ur,ux,ux,ux,ur,ur,ur
ur,cg,ug,ug,ur,ug,ur,ub,cr,ub,cb,ug,ug,ur,ur,ur,ur,ux,ux,ux,ur,ur,ur
ur,ur,ur,ug,ug,ub,ub,ub,ur,ug,ug,ur,ug,ur,ur,ur,ur,ur,ur,ur,ur,ur,ur
ur,ur,ug,ug,ug,ug,ug,ub,cb,ub,ur,ur,ug,ur,ur,ur,ur,ur,ur,ur,ur,ur,ur
ug,ur,ur,ur,ug,ub,ub,ub,ub,ub,ur,ur,ug,ug,ub,ub,ur,ur,ur,ur,ur,ur,ur
ug,ur,ug,ur,ug,ub,ux,ux,ub,ub,ub,ub,cb,ug,ub,ub,ug,ug,ug,ur,ur,ur,ur
ug,ur,ug,ur,ub,ub,ux,ux,ux,ub,ub,ub,ub,cg,ub,ub,ub,ug,ug,ur,ur,ur,ur
cg,ur,ug,ur,ub,ub,ug,ug,ug,ub,ug,ub,ub,ub,ub,ub,ub,ug,ug,ur,ur,ur,ur
ux,ur,ux,ur,ug,ub,ug,ux,ux,ub,ug,ux,ub,ub,ub,ug,ug,ug,ug,ug,ug,ur,ur
ux,ur,ug,ur,ug,ub,ub,ub,ub,ub,ub,ub,ub,ub,ub,cg,ub,ur,ug,cr,ur,ur,ur
ux,ur,ug,ur,ur,ur,ur,ur,ur,ub,ub,ub,ub,ur,ub,cb,ur,ur,ur,ur,ur,ur,ur
ux,ur,ur,ur,ur,ur,ur,ur,ub,ub,ub,ub,ub,ur,ur,ur,ur,ur,ur,ur,ur,ur,ur
ur,ux,ux,ux,ux,ux,ux,ux,ub,ub,ug,ux,ub,ur,ub,ur,ub,ux,ub,ux,ur,cr,ur
ur,ux,ux,ux,ux,ux,ux,ux,ug,ug,ux,ux,ux,ur,ub,ur,ub,ux,ub,ux,ub,ub,ur
ur,ur,ur,ur,ur,ub,ub,ub,ug,ug,ub,ub,ub,ur,ub,ur,ub,ub,ub,ub,ub,ux,cb
cg,ux,ux,ux,ux,ub,ux,ux,ux,ux,ux,ux,ux,ur,ux,ur,ux,ux,ub,ub,ux,ux,ux
cb,ux,ux,ux,ub,ub,ux,ux,ux,ub,ux,ux,ux,ur,ux,ur,ux,ux,ux,ux,ux,ux,ux
ux,ux,ub,ub,ub,ub,ub,ub,ub,ub,ux,ux,cg,ur,ux,ur,ux,ux,ux,ux,ux,cr,ux
ux,ux,ub,ub,ub,ub,cr,ux,cr,ub,cb,cg,cb,ur,ur,ur,cr,ux,ux,cr,ux,cr,cb