cb,cr,cr,ub,ub,cb,ub,ub,ug,ub,ub,ug,ux,ux,ux,ub,ux,ux,ur,ub,ub,cb,cb
ur,ur,ux,ur,ub,ug,cb,ub,ub,ub,ub,ub,ub,ub,ub,ub,ux,ux,ux,ub,ub,ub,cr
ur,ur,ux,ux,ux,ux,ub,ub,ub,ug,ug,ux,ux,ux,ux,ub,ub,ub,ub,ub,ux,ub,cb
ur,ur,ux,ux,ux,ux,ub,ub,ug,ug,ug,ux,ux,ux,ux,ux,ux,ux,ux,ux,ur,ur,cr
ur,ux,ux,ux,ux,ux,ug,ub,ub,ug,ug,ux,ux,ux,ux,ux,ux,ux,ux,ux,ub,ub,cb
ur,ux,ux,ux,ux,ux,ug,ug,cg,ug,ug,ux,ux,ux,ux,ux,ux,ux,ux,ux,ub,ub,ur
cr,ur,ux,ux,ux,ug,ug,ug,ux,ug,ug,ux,ux,ux,ux,ux,ux,ux,ux,ux,ub,ub,ub
ur,ur,ux,ux,ux,ug,ub,ug,ug,ug,ub,ub,ub,ub,ub,ux,ux,ux,ux,ub,ub,ub,ub
ub,ub,ub,ub,ub,ug,ug,ug,ub,ug,ub,ub,ub,ub,ub,ux,ux,ux,ux,ux,ux,ub,ub
cg,ub,ub,ux,ux,ux,ub,ub,ub,ug,cg,ug,ux,ub,ub,ux,ux,ux,ux,ub,ub,ub,ub
ug,ub,ub,ux,ux,ux,ub,ub,ub,ub,ug,ub,cb,ub,ub,ux,ux,ux,ux,ux,ux,ub,ub
ug,ub,ug,ug,ug,ug,ug,ub,ub,ub,ug,ub,ug,ub,ub,ux,ux,ux,ux,ux,ux,ux,ub
ub,ub,ub,ug,ug,ux,ux,ux,ux,ub,ug,ub,ub,ub,ub,ub,ub,ub,ub,ub,ub,ub,ub
cb,ub,ux,ug,ux,ux,ux,ux,ux,ub,ug,ub,ug,ug,ux,ug,ub,ux,ux,ux,ux,ux,ur
cb,ur,ux,ug,ux,ux,ux,ux,ux,ux,ux,ux,ux,ux,ux,ug,ub,ub,ux,ux,ux,ux,ur
cr,ur,ux,ug,ux,ux,ux,ux,ux,ux,ux,ux,ux,ux,ux,ux,ub,ub,ub,ux,ux,ux,ur
ur,ur,ux,ug,ux,ux,ux,ux,ux,ub,ub,ub,ub,ub,ux,ux,ub,cb,ub,ub,ub,ug,ur
ur,ur,ux,ug,ux,ux,ub,ub,ub,ub,ux,ux,ux,ub,ux,ux,ux,ux,ux,ux,ux,ug,ur
ur,ub,ux,ug,ug,ux,ub,ux,ux,ux,ux,ux,ux,ub,ux,ux,ux,ux,ux,ux,ub,ug,cr
ur,cr,ur,ux,ug,ux,ub,ux,ux,ux,ux,ux,ub,ub,ux,ux,ux,ux,ux,ux,ub,ug,cg
cg,cb,ub,ub,ub,ub,ub,ux,ub,ub,ub,ux,ub,ub,ub,ub,ub,ub,ub,ub,ur,ur,ug
cr,cb,ub,ug,ur,ur,ur,ub,ub,ub,ub,ub,ub,ub,ux,ux,ub,ux,ux,ur,ur,ug,cr
cg,cg,cb,cg,cr,ur,cr,cb,cr,cb,ub,ub,ub,ug,ug,ug,ug,ug,cg,ug,cr,cg,cg