ur,ur,cr,ur,ur,ur,cb,cb,cb,cb,ur,cg,cg,ur,ur,ur,ur,ur,ur,ur,cb,cb,cb
ur,ur,ur,ur,ur,ur,ur,ur,ur,ur,ur,ur,ur,ur,ur,ur,ur,ur,ur,ur,ur,ur,ur
ur,cr,cb,ur,ur,ur,ur,ur,ur,ur,ur,ur,ur,ur,ur,ur,ur,ur,ur,ur,ur,ur,ur
ur,ur,ur,ur,ur,ur,ur,ur,ur,ur,ur,ur,ur,ur,ur,ur,ur,ur,ur,ur,ur,ur,ur
ur,ur,ur,ur,ur,ur,ur,ur,ur,ur,ur,ur,ur,ur,ur,ur,ur,ur,ur,ur,ur,ur,ur
cg,ur,ur,ur,ur,ur,ur,ur,ur,ur,ur,ur,ur,ur,ur,ur,ur,ur,ur,ur,ur,ur,ur
cg,ur,ub,cr,ub,ub,ur,ur,ur,ur,ur,ur,ur,ur,ur,ur,ur,ur,ur,ur,ur,ur,ur
ub,cb,ub,ub,cr,ub,ub,ur,ur,ur,ur,ur,ur,ur,ur,ur,ur,ur,ur,ur,ur,ur,cb
ur,ur,ur,ur,ur,ub,ub,cb,cg,ur,ur,ur,ur,ur,ur,ug,ur,ur,ur,ur,ur,ur,ur
ug,ug,ug,ub,ub,ub,ub,ur,ur,ur,ur,ur,ur,ur,ur,ur,ur,ur,ur,ur,ur,ur,ur
ug,ug,ug,ug,ub,ub,ur,ur,ug,ur,ur,ur,ur,ur,ur,ur,ur,ur,ur,ur,ur,ur,ur
ug,ug,ug,ug,ur,ur,ur,ug,ug,ur,ur,ur,ur,ur,ur,ur,ug,ur,ur,ur,ur,ur,ur
ug,ug,ub,ug,ur,ur,ur,ur,ur,ur,ur,ur,ur,ur,ur,ur,ur,ur,ur,ur,ur,ur,ur
ug,ug,ur,ug,ur,ur,ur,ur,ur,ur,ur,ur,ur,ug,ug,ur,ur,ur,ur,ur,cr,cr,ug
cg,ug,ur,ug,ur,ur,ur,ur,ur,ur,ur,ub,ub,ug,ug,ur,ug,ug,ug,ug,ug,ug,ug
cb,ug,ur,ug,ur,ur,ub,ur,ur,ur,ur,ug,ub,ug,ug,ur,ug,ur,ur,ur,ur,ur,ug
ur,ur,ur,ug,ur,ur,ur,ur,ur,ur,ur,ug,ub,ub,ub,ur,ub,ur,ur,ur,ur,ur,ug
ur,ug,ug,ug,ur,ur,ur,ur,ur,ur,ur,ub,ur,ur,ub,ub,ub,ur,ur,ur,ur,ur,ug
cg,ug,ug,ug,ub,ug,ur,ug,ur,ur,ur,ub,ur,ur,ub,ub,ub,ur,ur,ur,ur,ur,ug
ug,ug,ug,ub,cb,ug,ur,ug,ug,ug,ur,ub,ub,ur,ub,ub,ub,ur,ur,ur,ur,ur,ug
cb,ug,ug,ug,ur,ur,ur,ur,ug,ug,ug,ug,ug,ug,ug,cb,ug,ug,ug,ug,ug,ug,ug
ug,ug,ug,ur,ur,cr,ub,cg,ug,ur,ur,ur,cg,ub,ub,ub,ub,ub,ub,ur,ur,cr,cb
cb,ug,ug,ug,ur,ur,cr,cr,cr,ur,ur,cg,cb,ub,ub,ub,ub,ub,ub,cr,ur,cr,cb