ur,ur,cr,ur,ur,ur,ur,cb,cb,cb,cg,cg,cg,ur,ub,ub,ub,cr,ub,ub,cb,cb,cb
ur,ur,ur,ur,ur,ur,ur,cg,ur,ur,cr,ur,ub,ub,ub,ug,ug,ur,ur,cb,ug,ug,ux
ur,cr,ur,ur,ur,ur,ur,ur,ur,ur,ur,ur,ug,ug,ug,ur,ux,ux,ux,ux,ux,ug,ux
ur,ur,ur,ur,ur,ur,ur,ub,ur,ur,ur,ur,ug,ug,ug,ur,ux,cg,ug,ug,ux,ug,ux
ur,ur,ur,ur,ur,ur,ur,ur,cr,ur,ur,ur,ub,ub,ur,ur,ux,ux,ux,ug,ux,ug,ux
ur,cr,ur,ur,ur,ur,ur,ur,cb,ur,ur,ur,ug,ug,ug,ug,ug,ux,ux,ug,ux,ug,ux
ur,ug,ur,ur,ur,ur,ur,ur,ub,ur,ur,ur,ub,ub,ub,ur,ug,ug,ug,ug,ux,ug,ux
ur,ug,ur,ur,ur,ur,ur,ur,ur,cr,ub,ub,ub,ub,ub,ur,ur,ux,ux,ux,ux,ug,ux
ur,ug,cg,ur,ur,ur,ur,ur,ur,ur,ub,ub,ur,ub,ub,ub,ub,ub,ub,ux,ux,ug,ux
ur,ur,ur,ur,ur,ur,ur,ur,ur,ur,ub,ub,ur,ur,ur,ub,ur,cb,ub,ug,ug,ug,ux
ux,ur,ur,ur,ur,ur,ur,ur,ur,ur,ub,ub,ur,ur,ur,ur,ur,ur,ur,ur,ur,ux,ux
ux,ur,ur,cr,ub,ub,ub,cb,ub,ub,ub,ug,ug,ug,ug,ub,ub,ug,ur,ug,ux,ux,ux
ur,ur,ur,ur,ur,ub,ub,ub,ub,cg,ug,ug,ug,ur,ug,ug,ug,ug,cr,ux,ux,ux,ux
ur,ur,ur,ur,ur,ur,ur,ux,ux,ux,cb,ug,ur,ur,ur,ug,ug,ug,ug,ux,ux,ux,ux
ur,ur,ur,ur,ur,ug,ur,ux,ux,ux,ux,ug,ug,ur,ur,ug,ug,ur,ug,ux,ux,ux,ux
ur,ur,ur,ur,ur,ur,ur,ux,ux,ux,ux,ux,ur,ur,ur,ur,ux,ug,ug,ux,ux,ux,ux
ur,ur,ur,ur,ux,ug,ug,ug,ug,ug,ug,ug,ur,ur,ur,ur,ux,ug,ur,ux,ux,ux,ux
ux,ux,ux,ux,ux,ux,ux,ux,ux,ux,ux,ux,ug,ug,ug,ug,ug,ug,ug,ux,cb,ub,ub
ux,ux,ux,ux,ux,ux,ux,ux,ux,ux,ux,ux,ug,ur,ur,ur,ub,ug,ug,ub,ub,ub,cb
cg,ux,ux,ux,ux,ux,ux,ux,ux,ux,ux,ux,ug,ug,ug,ug,ug,ug,cg,ub,ub,ub,ub
cb,ux,ux,ux,ux,ux,ux,ux,ux,ux,ux,ux,ux,ux,ux,ux,ub,ub,ux,ux,ub,ub,ub
ux,ux,ux,ux,ux,ux,ux,ux,ux,ux,ux,ux,cg,ux,ux,ux,cb,ux,ux,ux,ux,cr,cb
cb,ux,ux,ux,ux,ux,cr,cb,cr,ux,ux,cg,cb,ux,ux,ux,cr,ux,ux,cr,ux,cr,cb