ur,ur,cr,ug,ur,ur,ur,cb,cb,cb,ub,cg,cg,ub,ub,cb,ub,ub,ub,ur,cb,cb,cb
cg,ur,ug,ug,ur,ur,ug,ug,ug,ug,cb,ub,ub,ub,ub,ub,ub,ub,ug,cr,ug,ug,ug
ur,ur,ur,ug,ur,ur,ug,ug,ug,ug,ug,ug,ug,ub,ub,ub,ub,ub,ug,ur,ub,ub,ub
ur,ur,ur,ug,ur,ur,ug,ub,ug,ug,ug,ur,ur,ub,ur,ub,ub,ub,ub,ur,ub,ub,ub
ug,ug,ug,ug,ur,ur,ug,ub,cr,ub,ub,ur,ug,ub,ur,ur,ur,ur,ur,ur,ub,ub,ub
cg,ur,ug,ug,ur,ur,ur,ur,ur,ur,ur,ur,ur,ur,ub,ub,ub,ub,ub,ub,ub,ub,ub
cg,ug,ug,ug,ug,ug,ug,ug,ur,ug,ur,ug,ug,ur,ur,ur,ur,cr,ub,ur,ub,ub,ub
ub,ub,ug,ug,ur,ur,ub,ur,ur,ub,ur,ur,ug,ur,ub,ub,ub,ub,ug,ur,ub,ub,ub
ug,ug,cg,ug,ub,ur,ur,ub,ub,cb,ur,ur,ug,ur,ub,ub,ur,ur,ur,ur,ub,ub,ub
ug,ur,ug,ug,ub,ub,ub,ub,ur,ub,ur,ug,ug,ur,ur,ur,ub,ub,ub,ur,ub,ub,ub
ug,ur,ug,ug,ub,ug,ug,ug,ur,ug,cr,ug,ug,ur,ub,ur,ug,ug,ub,ur,ub,ub,ub
ug,ug,ug,ur,ug,ug,ug,ug,ur,ug,ur,ur,ur,ur,ub,ur,ub,ub,ub,ur,ub,ur,ub
ug,ug,ug,ug,ug,ug,ug,ug,ur,ur,ur,ug,ug,ug,ub,ur,ug,ug,ug,ur,ub,ub,ub
ug,ug,ug,ug,ug,ug,ug,ug,ur,ub,ur,ub,ub,ub,ub,ub,ug,ug,ub,ur,ur,ur,ub
cg,ub,cg,ug,ub,ug,ug,ug,ur,ug,ur,ub,ub,ub,ub,ub,ug,ug,ug,ur,ub,ub,ub
ug,ub,ub,cb,ub,ug,ug,ug,ur,ug,ur,ug,ub,ub,ub,ur,ug,ug,ug,ur,ub,ub,ub
ug,ub,ub,ub,ub,ub,ub,ug,ur,ur,ur,ug,ub,ub,ub,ub,ur,ub,ug,ur,ur,ur,ub
ug,ug,ub,ub,ub,ub,ub,ur,ur,ur,ur,ub,ub,ub,ub,ug,ug,ug,ug,ur,ur,ur,ub
ug,ug,ug,ub,ub,ub,ug,ub,ur,ur,ub,cb,ub,ub,ub,ub,ub,cb,ur,ur,ur,ur,ub
ug,ug,ug,ug,ug,ug,ug,ub,ur,ur,ub,ub,ub,ub,ub,ub,ub,ub,ub,ur,ub,ub,ub
cb,ug,ug,ug,ug,ug,ug,ub,ur,ur,ug,ub,ub,ub,ub,ub,ur,ug,ur,ur,ur,ur,ug
ug,ug,ug,ug,ug,ug,ug,ug,ur,ur,ug,ub,cg,ub,ub,ug,ur,ug,ur,ur,ur,cr,cb
cb,ug,ug,ug,ug,ug,cr,ug,ur,ur,ur,cg,cb,ub,ub,ub,ur,ur,ur,cr,ub,cr,cb