ur,ur,cr,ur,ur,ur,ur,cb,cb,cb,cg,ur,cg,ur,ur,ur,ur,ur,ur,cb,cb,ux,cb
ur,ur,ur,ur,ur,ug,ur,ur,ur,ur,ur,ur,ur,ur,ur,ur,ur,ur,ur,ur,ur,cb,cb
ur,ur,ur,ur,ur,cr,ur,ur,ug,ur,ur,ur,ur,ur,ur,ur,ur,ur,ur,ur,ur,ur,ur
cg,ur,cr,cr,ur,cg,ug,ug,cr,ur,ur,ur,ur,ub,ub,ur,ur,ur,ur,ur,ur,ur,ur
ur,ur,ur,ur,ug,ug,ug,ug,ur,cg,ug,ur,cr,ur,ub,ur,ur,ur,ur,ur,ur,ux,ux
ur,ur,ur,ug,cg,ug,ug,ug,ur,ug,ug,ur,cb,ub,ub,ub,ug,ux,ux,ux,ux,ux,ux
ur,ur,ub,ub,ub,ub,ur,ub,ub,ub,ub,ur,ug,ub,ug,ub,ug,ug,ux,ur,ur,ur,ur
ub,ub,ub,ub,ub,ub,ur,ur,ur,ur,ub,cb,ur,ub,ug,ug,ug,ug,ux,ur,ux,ux,ur
ub,ub,ub,ub,ub,ub,ub,ux,ux,ur,ur,ur,ur,ub,ur,ub,ub,cr,ub,ur,ur,ub,cb
ub,ub,ur,ux,ub,ub,ub,ux,ux,ur,ur,ur,ur,ub,ur,ub,ub,ur,cb,ur,ux,ub,ux
ub,ux,ur,ux,ub,ux,ux,ux,ux,ur,ur,ur,ur,ur,ur,ux,ub,ur,ub,ub,ub,ub,ub
ub,ux,ur,ub,ub,ux,ux,ug,ux,ub,ug,ub,ub,ub,ub,ub,ub,ur,ub,ub,ub,ub,ub
ub,ux,ur,ub,ux,ux,ug,ug,ub,ug,ug,ub,ub,ub,ub,ub,ub,ur,ur,ur,ub,ub,ub
ub,ux,ur,ub,ux,ux,ux,ug,ug,cg,ux,ub,ub,ub,cb,ub,ub,ur,ur,ur,ub,ub,cg
ub,ux,ur,ub,ux,ux,ux,ug,ug,ug,ug,ur,ur,ur,ub,ub,ur,ur,ur,ur,ur,ub,ub
ub,ux,ur,ub,ux,ux,ux,ux,ux,ux,ux,ur,ug,ug,ux,ux,ux,ub,cr,ur,ub,ub,ub
ub,ux,ur,ub,ub,ux,ux,ux,ux,ux,ux,ur,ux,ux,ux,ux,ux,ub,ub,ur,ur,ur,ur
ub,ux,ur,ub,ub,ub,ub,ub,ub,ub,ub,ur,ub,ux,ux,ux,ux,ub,ub,ur,ur,ur,ur
ub,ub,ur,ub,ub,ub,ur,ur,ur,ur,ur,ur,ux,ux,ux,ux,ux,ub,ub,ur,ur,ur,ur
cg,ub,ur,ub,ub,ur,ur,ux,ux,ux,ux,ux,ux,ux,ux,ux,ux,ur,ur,ur,ur,ur,ur
cb,ub,ur,ux,ub,ur,ux,ux,ux,ux,ux,ux,ux,ux,ux,ux,ux,ur,ur,ur,ur,ur,ur
ub,ub,ur,ur,ur,ur,ux,ux,ux,ux,ux,ux,cg,ux,ux,ux,ux,ux,ux,ux,ur,cr,ur
ub,ub,ub,ub,ub,ux,cr,ux,cr,ux,ux,cg,cb,ux,ux,ux,cr,ux,ux,cr,ur,cr,cb