ux,ux,cr,ux,ux,ux,ux,cb,cb,cb,ur,cg,cg,ur,ur,ur,ur,ur,ur,ur,cb,cb,cb
ux,ux,ux,ux,ur,ux,ux,ux,ur,ur,ur,ur,cb,ur,ur,ur,cr,ub,cr,ur,ub,ux,ux
ux,cr,ux,ux,ur,ur,ur,ur,ur,ur,ur,ur,ur,ur,ur,ur,ur,ux,ux,ub,ub,ux,ux
cg,cr,ug,cg,ur,ur,ur,ur,ur,ur,ur,ur,ur,ur,ur,cr,ub,ub,ub,ub,ux,ux,ux
ug,ur,ur,ur,ug,ur,ur,ur,ur,ur,ur,ur,ur,ur,ub,ux,ug,ub,ub,ux,ux,ux,ux
ug,ug,ug,ur,ug,ug,ux,ur,ur,ur,ur,ur,ur,ur,ub,ux,ug,ug,ug,ux,ux,ux,ux
ug,ug,ug,ur,ug,ug,ur,ur,ur,ur,cg,ur,ur,cr,ub,ug,ux,ux,ux,ux,ux,ux,ux
ug,ug,ug,ur,ug,ur,ur,ur,ur,ur,ug,ur,cb,ub,ug,ug,ux,ux,ux,ux,ux,ux,ux
cb,ur,ub,ur,ug,ur,ux,ur,ur,ub,ug,ub,ub,ug,ub,ug,ux,ux,ux,ux,ux,ux,ux
ub,ur,ub,ur,ug,ur,ug,ux,ux,ub,ug,ux,ux,ug,ub,ug,ux,ux,ux,ux,ux,ux,ux
ub,ub,ub,ur,ub,ub,ux,ub,ub,ub,ug,ug,ug,ug,ub,ug,ux,ux,ux,ux,ux,ux,ux
ub,ub,ug,ug,ub,ub,ux,ub,ux,ux,ux,ub,ub,ub,ub,ug,ux,ux,ux,ux,ux,ux,ux
ug,ug,ur,ur,ub,ug,ux,ub,ux,ux,ux,ux,ux,ub,ub,ug,ux,cg,ux,ux,ux,ux,ux
ug,ug,ux,ux,ub,ug,ub,ub,ux,ux,ux,ux,ux,ub,ub,cb,ux,ug,ux,ux,ux,ux,ux
ug,ug,ux,ux,ub,ug,ux,ux,ux,ux,ux,ux,ux,ub,ub,ub,ux,ug,ux,ux,ux,ux,ux
ug,ug,cr,ux,cb,ug,ux,ux,ux,ux,ux,ux,ux,ub,ub,ub,ug,ug,ux,ux,ux,ux,ux
ug,ug,ur,ux,ur,ug,ux,ux,ux,ux,ux,ux,ux,ub,ub,ub,ux,ux,ux,ux,ux,ux,ux
ug,ug,ur,ux,ur,ug,ux,ux,ux,ux,ux,ux,ux,ub,ux,ux,ux,ux,ux,ux,ux,ux,cg
ux,ur,ur,ux,ur,ug,ux,ug,ux,ux,ux,ux,ux,ub,ux,ux,ux,ux,ux,ux,ux,ux,cb
cg,ur,ur,ux,ur,cg,ux,ug,ux,ux,ux,ux,ux,ub,ux,ux,ub,ux,ux,ux,ux,ux,ux
cb,ur,ur,ur,ur,ur,ur,ur,ur,ur,ur,ur,ur,ur,ur,ur,ur,ur,ur,cr,ux,ux,ux
ux,ur,ur,ur,ur,ux,ux,ux,ux,ux,ux,ux,cg,ub,ux,ux,ub,ux,cb,ux,ux,cr,cb
cb,ux,ux,ux,ux,ux,cr,cb,cr,ux,ux,cg,cb,cb,ub,ub,ub,ub,ub,cr,ux,cr,cb