ur,ur,cr,ur,ur,ur,ur,cb,cb,cb,cg,cg,cg,ur,ub,ub,cb,ur,ur,cr,cb,cb,cb
ur,ur,ur,ur,ur,ur,ur,cg,ub,ub,cr,ur,ub,ub,ub,ug,ug,ug,ug,ug,ug,ug,ux
ur,cr,cr,ur,ur,ur,ur,ur,ub,ur,ur,ur,ug,ug,ug,ur,ux,ux,ux,ux,ux,ug,ux
ur,ur,ug,ur,ur,ur,ur,ub,cb,cr,ur,ur,ug,ug,ug,ur,ux,ux,ux,ux,ux,ug,ux
ur,ug,ug,ur,ur,ur,ur,ur,ur,ur,ur,ur,ub,ub,ur,ur,ux,ux,ux,ux,ux,ug,ux
ur,cg,ur,ur,ur,ur,ur,ur,ub,ur,ur,ur,ug,ug,ug,ug,ug,ux,ux,cg,ux,ug,ux
ur,ur,ur,ur,ur,ur,ur,ur,ur,ur,ur,ur,ub,ub,ub,ur,ug,ug,ug,ug,ux,ug,ux
ur,ur,ur,cr,ur,ur,ur,ur,ur,ub,ub,ub,ub,ub,ub,ur,ur,ux,ux,ux,ux,ug,ux
ur,ur,ur,ub,ur,ur,ur,ur,ur,ub,ub,ub,ur,ub,ub,ub,cb,ux,ux,ux,ux,ug,ux
ur,ur,ur,ub,ur,ur,ur,cr,ub,ub,ub,ub,ur,ur,ur,ub,ur,ur,ug,ug,ug,ug,ux
ux,ur,ur,ub,ur,ur,ur,ur,ur,ur,ub,ub,ur,ur,ur,ur,cr,ug,ug,ur,ur,ux,ux
ux,ur,ur,cb,ur,ur,ub,ub,ub,ub,ub,ug,cg,ug,ug,ub,ub,ug,ug,ug,ux,ux,ux
ur,ur,ur,ur,ur,ub,ub,ub,ub,ub,ub,ub,ub,ur,ug,ug,ug,ug,ug,ux,ux,ux,ux
ur,ur,ur,ur,ur,ur,ur,ux,ux,ux,cb,ug,ur,ur,ur,ug,ug,ug,ug,ux,ux,ux,ux
ur,ur,ur,ur,ur,ug,ur,ux,ux,ux,ux,ug,ug,ur,ur,ug,ug,ur,ug,ux,ux,ux,ux
ur,ur,ur,ur,ur,ur,ur,ux,ux,ux,ux,ux,ur,ur,ur,ur,ux,ug,ug,ux,ux,ux,ux
ur,ur,ur,ur,ux,ug,ug,ug,ug,ug,ug,ug,ur,ur,ur,ur,ux,ug,ur,ux,ux,ux,ux
ux,ux,ux,ux,ux,ux,ux,ux,ux,ux,ux,ux,ug,ug,ug,ug,cg,ug,ur,ux,ux,ub,ub
ux,ux,ux,ux,ux,ux,ux,ux,ux,ux,ux,ux,ug,ur,ur,ur,ub,ug,ur,ub,ub,ub,cb
cg,ux,ux,ux,ux,ux,ux,ux,ux,ux,ux,ux,ug,ug,ug,ug,ug,ug,ur,ub,cb,ub,ub
cb,ux,ux,ux,ux,ux,ux,ux,ux,ux,ux,ux,ux,ux,ux,ux,ub,ub,ux,ux,ub,ub,ub
ux,ux,ux,ux,ux,ux,ux,ux,ux,ux,ux,ux,cg,ux,ux,ux,cb,ux,ux,ux,ux,cr,cb
cb,ux,ux,ux,ux,ux,cr,cb,cr,ux,ux,cg,cb,ux,ux,ux,cr,ux,ux,cr,ux,cr,cb