ur,ur,cr,ur,ur,ur,cb,cb,cb,cb,ur,cg,cg,ur,ur,ur,ur,ur,ur,ur,cb,cb,cb
ur,cg,ug,ug,ug,ur,ur,ur,ur,ur,ur,ur,ur,ur,ur,ur,ur,ur,ur,ur,ur,ur,ur
ur,cr,cb,ur,ug,ur,ur,ur,ur,ur,ur,ur,ur,ur,ur,ur,ur,ur,ur,ur,ur,ur,ur
ur,ur,ur,ur,ug,ur,ur,ur,ur,ur,ur,ur,ur,ur,ur,ur,ur,ur,ur,ur,ur,ur,ur
ur,ur,ur,ur,ug,ur,ur,ur,ur,ur,ur,ur,ur,ur,ur,ur,ur,ur,ur,ur,ur,ur,ur
cg,ur,ur,ur,ug,ur,ur,ur,ur,ur,ur,ur,ur,ur,ur,ur,ur,ur,ur,ur,ur,ur,ur
cg,ur,ur,ur,ug,ur,ur,ur,ur,ur,ur,ur,ur,ur,ur,ur,ur,ur,ur,ur,ur,ur,ur
ub,ur,ur,ur,ug,ur,ur,ur,ur,ur,ur,ur,ur,ur,ur,ur,ur,cb,ur,ur,ur,ur,cb
ub,ur,ur,ur,ug,ur,ur,ur,cg,ur,ur,ur,ur,ur,ur,ug,ur,ub,ur,ur,ur,ur,ur
cb,ur,ur,ur,ur,ub,cb,ub,ur,ur,ur,ur,ur,ur,ur,ur,ur,ub,ur,ur,ur,ur,ur
ub,ur,ur,ur,ur,ur,ur,cr,ug,ur,ur,ur,ur,ur,ur,ur,ur,cr,ur,ur,ur,ur,ur
ub,ur,ur,ur,ur,ur,cr,ug,ug,ur,ur,ur,ur,ur,ur,ur,ug,ur,ur,ur,ur,ur,ur
ur,ur,ug,ur,ug,ur,ug,ur,ur,ur,ur,ur,ur,ur,ur,ur,ur,ur,ur,ur,ur,ur,ur
ug,ur,ug,ur,ug,ur,ug,ur,ur,ur,ur,ur,ur,ur,ur,ur,ur,ur,ur,ur,ur,ur,ur
cg,ur,ug,ur,ug,ur,ug,ur,ur,ur,ur,ub,ub,ur,ur,ur,ur,ur,ur,ur,ur,ur,ur
cb,ur,ur,ur,ur,ur,ur,ur,ur,ur,ur,ug,ub,ur,ur,ur,ur,ur,ur,ur,ur,ur,ur
ur,ur,ur,ur,ug,ug,ur,ur,ur,ur,ur,cr,ub,ur,ur,ur,ur,ur,ur,ur,ur,ur,ur
ur,ug,ug,ub,ug,ub,ur,ur,ur,ur,ur,ur,ur,ur,ur,ur,ur,ur,ur,ur,ur,ur,ur
ur,ur,ur,ur,cr,ur,ur,ur,ur,ur,ur,ur,ur,ur,ur,ur,ur,ur,ur,ur,ur,ur,ur
ug,ug,ug,ub,ug,cg,ub,ur,ur,ur,ur,ur,ub,ur,ub,ub,cr,ur,ur,ur,ur,ur,ub
cb,ug,ug,ug,ug,ug,ub,ur,ur,ur,ur,ur,ug,ug,ug,ub,ub,ub,ub,ub,ub,ub,ub
ug,ug,ug,ur,ug,ug,ub,cb,ur,ur,ur,ur,cg,ub,ub,ub,ub,ub,ub,ur,ur,cr,cb
cb,ug,ug,ug,ug,ug,cr,ur,cr,ur,ur,cg,cb,ub,ub,ub,ub,ub,ub,cr,ur,cr,cb