ug,ug,cr,cb,ur,ur,ur,cb,cb,cb,ur,cg,cg,ur,ur,ur,ub,ur,ur,ur,cb,cb,cb
ug,cr,ur,ub,cr,ur,ur,ur,ur,ur,ur,ur,ur,ub,ub,ub,ub,ub,ub,ub,ub,ub,ub
ug,cr,ur,ur,ur,ur,ur,ur,ur,ur,ur,ur,ur,ub,ub,ub,ub,ub,ub,ub,ub,ub,ub
ug,ug,ur,ur,ur,ur,ur,ur,ur,ur,ur,ug,ur,ur,ur,ur,ur,ur,ur,ur,ur,ur,ur
ug,ug,ug,ug,ur,ug,ug,ur,ur,ur,ur,ug,ur,ur,ur,ur,ur,ur,ur,ur,ur,ur,ub
cg,ug,ug,ur,ur,ur,ug,ur,ur,ur,ur,ur,ur,ug,ug,cr,ub,ub,ub,ur,ur,ub,ub
cg,ug,ug,ug,ub,ur,ub,ur,ur,ur,ur,ur,ur,ug,ur,ur,ug,ug,ub,ur,ub,ub,ub
ur,ur,ug,ur,ur,ur,ub,ur,ur,ug,ug,ur,ur,ug,ub,ur,ub,ug,ug,ur,ur,ur,ub
ur,ur,ug,ug,ug,ug,ug,cg,ur,ug,ug,ur,ur,ug,ug,ur,ur,ug,ur,ur,ub,ur,ub
ur,ur,ub,cb,ub,ub,ub,ub,ub,ug,ug,ug,ub,ug,ub,ur,ub,ug,ug,ug,ub,ur,ub
ur,ur,ur,cr,ub,ug,ub,ub,ub,ug,ub,ug,ug,ug,ug,ur,ug,ur,ur,ug,ur,ur,ub
ur,ug,ur,ub,ub,ub,ub,ub,ub,ug,ub,ug,ub,ub,ug,ur,ub,ur,ub,ug,ub,ur,ub
cg,ug,ur,ur,ur,ub,ub,cb,ub,ub,ub,ug,ub,ub,ub,ur,ug,ur,ug,ug,ub,ub,ub
ug,ug,ub,ub,ur,ub,ub,ub,ub,ug,ub,ug,ug,ug,ug,ur,ug,ur,ub,ug,ur,ur,ub
cg,ug,ug,ug,ur,ub,ur,ur,ur,ug,ug,ug,ug,ug,ug,ur,ur,ur,ug,ug,ub,ub,ub
ub,ug,ur,ug,ug,ug,ug,ug,ur,ug,ug,ug,ug,ug,ug,ur,ug,ug,ug,ug,ub,cb,ub
ub,ug,ur,ug,ug,ur,ur,ug,ur,ug,ur,ug,ub,ur,ub,ur,ur,ub,ug,ug,ub,ub,ub
ub,ug,ur,ug,ug,ug,ug,ug,ur,ug,ug,ug,ug,ug,ug,cg,ug,ug,ug,ug,ub,ub,ub
ub,ug,ur,ub,ug,ug,ug,ug,ub,ur,ur,ug,ur,ug,ug,ug,ug,ug,ug,ub,ub,ur,ub
ub,ub,ub,ub,ug,ug,ug,ug,ub,ur,ur,ug,ur,ub,ug,ug,ub,ub,ub,ub,ub,ub,ub
cb,cb,ub,ub,ug,ug,ug,ug,ub,ur,ur,ug,ur,ur,ur,ur,ur,ur,ur,ub,ub,ur,ug
ug,ug,ug,ug,ug,ug,ug,ug,ug,ur,ur,ug,cg,ur,cb,ur,ub,ur,ur,ub,ub,cr,cb
cb,ug,ug,ug,ug,ug,cr,ug,cr,ur,ur,cg,cb,ur,ub,ub,ub,ub,ub,cr,ub,cr,cb