cr,ur,cr,ug,ug,ug,ur,cb,cb,cb,ur,cg,cg,ur,ur,ur,ub,ur,ur,ur,cb,cb,cb
cg,ub,ub,ub,ug,ug,ub,ub,ur,ur,ur,ur,ur,ur,ur,ur,ur,ur,ur,ur,ug,ug,ug
ug,ug,ug,ug,ug,ug,ug,ug,ur,ur,ur,ur,ur,ur,ur,ur,ur,ur,ur,ur,ub,ub,ub
ug,ug,ug,ug,ug,ug,ug,ub,ur,ur,ur,ub,ub,ub,ur,ub,ub,ub,ub,ur,ub,ub,ub
ug,ug,ug,ug,ug,ug,ug,ub,ur,ub,ub,ur,cr,ur,ur,ur,ur,ur,ur,ur,ub,ub,ub
ug,ug,ug,ug,ug,ug,ug,ug,ur,ub,ub,ub,cb,ur,ub,ub,ub,ub,ub,ub,ub,ub,ub
cg,ug,ug,ug,ug,ug,ug,ug,ur,ug,ub,ub,cb,ur,ur,ur,ur,ur,ur,ur,ub,ub,ub
ub,ug,ug,ug,ug,ug,ug,ug,ur,ub,ub,ub,ub,ur,ub,ub,ub,ub,ug,ur,ur,ur,ub
ug,ug,ug,ug,ug,ur,ur,ub,ur,ub,ub,ub,ug,ur,ug,ug,ur,ur,ur,ur,ub,ur,ub
ug,ug,ug,ug,ug,ub,ub,ub,ur,ub,ub,ub,ur,ur,ug,ug,ub,ub,ub,ur,ub,ur,ub
ug,ug,ug,ug,ug,ug,ug,ug,ur,ur,ub,ub,ub,ur,ug,ug,ug,ur,ur,ur,ur,ur,ub
ug,ug,ug,ur,ug,ur,ur,ur,ur,ug,ub,ub,ub,ug,ug,ug,ub,ur,ub,ur,ub,ur,ub
ug,ub,ug,ug,ug,ur,ur,ur,cb,ub,ub,ub,ub,ub,ub,ug,ug,ur,ug,ur,ub,ub,ub
ug,ug,ub,ub,ug,ur,ub,ur,ur,ub,ub,ug,ug,ug,ug,ug,ug,ur,ub,ur,ur,ur,ub
cg,ug,ug,ug,ug,ur,ub,ur,ur,ub,ub,ug,ug,ug,ug,ug,ur,ur,ug,ur,ub,ub,ub
ug,ug,ug,ub,ug,ur,ub,ur,ur,ub,ur,ur,ur,ur,cg,ug,ug,ug,ug,ur,ub,ub,ub
ug,ug,ug,ug,ug,ur,ug,ur,ur,ub,ur,ur,ub,ur,ub,ub,ur,ub,ug,ur,ur,ur,ub
ug,ug,ug,ug,ug,ur,cr,ur,ur,ub,ur,ub,ub,ur,ub,ug,ug,ug,ug,ur,ur,ur,ub
ug,ug,ug,ub,ug,cg,ug,ub,cr,ur,cb,ub,ur,ur,ur,ub,ub,ub,ur,ur,ur,ur,ub
ug,ug,ug,ug,ug,ur,ug,ub,ur,ub,ub,ub,ub,cb,ub,ub,ub,ub,ub,ur,ub,ub,ub
cb,ug,ug,ug,ug,ur,ug,ub,ur,ub,ub,cb,ub,ub,ub,ub,ub,ug,ur,ur,ur,ur,ug
ug,ug,ug,ug,cg,ur,ug,ug,cr,ub,ub,ub,cg,ub,ub,ub,ub,ug,ur,ur,ur,cr,cb
cb,ug,ug,ug,ur,ur,cr,ug,ur,ub,ub,cg,cb,ub,ub,ub,ur,ur,ur,cr,ub,cr,cb