ur,ur,cr,ur,ur,ur,ux,cb,cb,cb,ux,cg,cg,ur,ub,ub,ug,ug,ug,ux,cb,cb,cb
ur,ur,ur,ur,ur,ur,ur,ur,ur,ux,cr,ux,cb,ur,ub,ub,ub,ub,ub,ub,ub,ug,ux
ur,cr,ur,ur,ur,ur,ur,ur,cr,ug,ur,ug,ug,ug,ub,ub,ur,ux,ux,ub,ub,ug,ux
ur,ur,ur,ur,ur,ur,ur,ur,ur,ux,ur,ur,ur,ug,ug,ug,ug,ur,ub,ub,ur,ug,ur
ur,ur,ur,ur,cr,ux,ux,ug,ur,ur,ur,ur,ur,ug,ub,ur,ug,ur,cb,ux,ur,ur,ur
ur,cg,ug,ug,ur,ug,ux,ug,ur,ur,ur,ug,ug,ug,ur,ur,ug,ug,ug,ug,ux,ux,ux
ur,ur,ub,ub,ur,ug,ur,ug,ug,ug,ur,ug,cg,ur,ur,ur,ur,ux,ug,ug,ux,ux,ux
ur,ur,ur,cb,ur,ur,ur,ur,ur,cg,ur,ur,ur,ur,ub,ub,ux,ux,ug,ug,ux,ux,ux
ur,ur,ur,ur,ur,ur,ur,ur,ur,cb,ur,ur,cr,ux,ux,ux,ug,ug,ug,ug,ux,ux,ux
ux,ub,cr,ur,ur,ur,ug,ug,ux,ub,ub,ub,ub,ux,ux,ux,ug,ug,ug,ug,ux,ux,ux
ug,ub,ug,cg,ug,ur,ug,ub,ub,ub,ub,ub,ub,ub,ux,ux,ux,ux,ux,ux,ux,ux,ux
ug,cb,ub,ub,ux,ur,ug,ub,ux,ux,ux,ub,ub,ub,ux,ux,ux,ux,ux,ux,ux,ux,ux
ug,ur,cr,ub,ug,ur,ug,ub,ub,ux,ux,ux,ux,ub,ux,ux,ux,ux,ux,ux,ux,ux,ux
ug,ur,ux,ux,ub,ur,ub,ub,ux,ux,ux,ux,ux,ub,ux,ux,ux,ux,ux,ux,ux,ux,ux
ug,ur,ux,ux,ub,ur,ur,ug,ux,ux,ux,ux,ux,ub,ux,ux,ux,ux,ux,ux,ux,ux,ux
ug,cg,ug,ux,ub,ur,ur,ug,ur,ur,ur,ur,ur,ub,ur,ur,ux,ux,ux,ux,ux,ux,ux
ug,ug,ux,ux,ub,ur,ur,ug,ur,ur,ur,ur,ur,ub,ur,ur,ux,ux,ux,ux,ux,ux,ux
ug,ug,ug,ux,ub,cr,ur,ug,ux,ux,ux,ux,ux,ub,ux,ux,ux,ux,ux,ux,ux,ux,cg
ux,ur,ug,ux,ub,ub,ur,ug,ux,ux,ux,ux,ux,cb,ux,ux,ux,ux,ux,ux,ux,ux,cb
cg,ur,ug,ux,ux,ux,ur,ug,ux,ux,ux,ux,ux,ux,ux,ux,ux,ux,ux,ux,ux,ux,ux
cb,ur,ug,ug,ug,ug,ug,ug,ux,ux,ux,ux,ux,ub,ub,cb,ux,ux,ux,ux,ux,ux,ux
ux,ur,ur,ur,ur,ur,ur,ux,ux,ux,ux,ux,cg,ub,ux,ux,ub,ux,ux,ux,ux,cr,cb
cb,ux,ux,ux,ux,ux,cr,cb,cr,ux,ux,cg,cb,ub,ub,ub,ub,ub,ub,cr,ux,cr,cb