cb,ur,ur,cr,ur,ur,ur,cb,ub,ub,ub,ub,ub,ur,ur,ur,ur,ur,ur,cr,cb,cb,cb
ur,cr,ur,ug,ur,ur,ub,ub,ug,ub,ug,ug,ur,ub,ub,ub,ub,ub,ub,ur,ub,cb,cb
ur,ur,ug,ug,ug,ug,ug,ug,ug,ug,ug,ug,ur,ub,ub,ub,ub,ub,ub,ub,ub,ub,cb
ur,ur,ug,ug,ug,ug,ug,ug,ug,ub,cg,ub,ub,ub,ub,ub,ub,ub,ub,ub,ub,ur,cr
cr,ub,ub,ug,ub,ur,ur,ur,ug,cb,ub,ub,ub,ub,ub,ub,ub,ub,ub,ur,ub,ur,cr
cb,ug,ug,ug,ug,ug,ug,ug,ug,cb,ub,ub,ur,ub,ub,ub,ur,ur,ur,ur,ub,ur,ur
ug,ur,ug,ub,ub,ub,ub,ur,ub,ub,ub,ur,ur,ub,ug,ub,ug,ux,ux,ux,ur,ur,ur
ug,ug,ug,ug,ug,ub,ub,ub,ub,ur,ur,ur,ux,ub,ub,ub,ug,ux,ux,ux,ur,ub,ub
ug,ug,ug,ug,ug,ur,ub,ux,ur,ur,ux,ug,ux,ub,ug,ub,ub,ub,ub,ub,ur,ub,ub
cg,cg,ur,ug,ub,ur,ur,ur,ur,ur,ux,ug,ug,ub,ub,ug,ug,ug,ug,ux,ur,ub,ub
cr,ur,ur,ug,ub,ur,ur,ux,ux,ur,ux,ux,ug,ug,ub,ug,ug,ug,ug,ug,ur,ub,ub
ur,ur,ur,ub,ub,ux,ux,ux,ux,ur,ux,ux,ux,ub,ug,ug,ug,ug,ug,ug,ur,ub,ub
cr,ub,ur,ur,ur,ur,ur,ug,ug,ug,ug,ug,ug,ug,ug,ug,ug,ug,ug,ug,ur,ub,ub
ur,ub,ub,ug,ug,ux,ur,ux,ug,ug,ug,ug,ug,ug,ug,ug,cg,ug,ub,ug,ur,ub,ub
ur,ur,ub,ur,ug,ug,ur,ug,ug,ug,ug,ug,ug,ug,ug,ug,ux,ug,ux,ug,ur,ur,ub
ur,ur,ur,ur,ur,ug,ur,ug,ug,ug,ug,ug,ug,ug,ug,ug,ug,ug,ug,ug,ub,ub,ub
ur,ux,ub,ux,ur,ux,ur,ur,ur,ug,ux,ux,ub,ub,ub,ux,ub,ub,ug,ug,ux,ub,ub
ur,ur,ub,ur,ur,ur,ur,ur,ur,ug,ur,ub,ub,ub,ub,ug,ub,ub,ub,ub,ub,ub,ur
ug,ub,ub,ub,ub,ur,ur,ur,ur,ur,ur,ur,ux,ux,ub,ux,ub,ub,ub,ub,ub,cb,ub
ug,ub,ux,ug,ub,ur,ur,ur,ur,ur,ur,ub,ux,ux,ub,ub,ub,ub,ub,ub,ub,ub,cr
cg,ug,ug,ug,ug,ur,ur,ur,ur,ur,ur,ub,ub,ub,ub,ub,ub,ub,ub,ub,ur,ub,cg
cb,ub,ub,ug,cr,ur,ur,ur,ur,ur,ug,ug,ub,ub,ub,ub,ub,ub,ub,ub,ug,cb,cr
cg,cg,ub,ub,ug,cr,cr,ur,ur,cr,cg,ug,ug,cb,ub,ub,cb,ub,ub,ub,cg,ug,cg