ur,ur,cr,ur,ur,ur,ur,cb,cb,cb,cg,cg,cg,ur,ur,ur,ur,ur,ux,ux,cb,cb,cb
ur,ur,ur,ur,ur,ur,cr,ur,ur,ur,ur,ur,ur,ub,ub,ub,ur,ur,ux,ux,ux,ux,ux
ur,cr,ug,cr,ur,ur,ur,ur,ur,ur,ur,ur,ur,ux,ux,ub,ub,ub,ub,ub,ux,ux,ux
cb,ur,ug,ug,cg,ur,ur,ur,ur,ur,ur,ug,ug,ub,ub,ub,ub,ub,ub,ub,ux,ux,ur
ux,ur,ur,cg,ug,ur,ur,ur,ur,ur,ur,ug,ug,ub,ub,ur,ur,ub,ub,ub,ux,ux,ur
cr,ur,ur,ur,ug,ur,ur,ur,ur,ur,ur,ug,ug,ub,ub,ur,ur,ub,ub,ub,ur,ux,ur
ux,ur,ur,cr,cr,ug,ug,ub,ur,ur,ug,ug,ub,ub,ub,ub,ub,ub,ub,ub,ur,ux,ur
ur,ur,ur,ur,cb,ug,cg,ub,ur,ug,ug,ug,ug,ub,ub,ub,ub,ub,ub,ub,ur,cr,ur
ur,ur,ur,ur,ur,ur,ur,ux,ux,ug,ur,ux,ug,ub,ub,ub,ug,ug,ug,ug,ub,ur,ur
ur,ur,ur,ur,ur,ur,ur,ux,ux,ug,ur,ux,ux,ub,ub,ub,ug,ug,ug,ug,ur,ur,ur
ur,ur,ur,ur,ub,ub,ux,ux,ux,ux,ur,ux,ux,ug,ub,ug,ug,ug,ug,ug,ub,cb,ub
ur,ur,ur,ur,ur,ub,ux,ux,ux,ux,ur,ux,ux,ug,cg,ug,ug,ug,ug,ug,ur,ub,ub
ub,ub,ur,ur,ux,ub,ux,ux,ux,ub,ur,ux,ug,ug,ub,ub,ug,ug,ug,ug,ur,ub,ub
ub,ub,ug,ux,ux,ub,ux,ux,ux,ub,ur,ux,ux,ub,ub,ug,ug,ug,ug,ug,ur,ub,ub
ub,ux,ug,ux,ux,ub,ux,ux,ux,ub,ur,ub,ub,ub,ug,ux,ux,ub,ub,ur,ur,ub,ub
ub,ub,ug,ux,ux,ub,ux,ux,ux,ub,ur,ub,ub,ub,ub,ub,ub,ub,ux,ur,ur,ub,ub
ub,ub,cr,ux,ux,ub,ux,ux,ux,ur,ur,ub,ub,ub,cg,ub,ub,ub,ub,ur,ur,ub,ub
ux,ux,ur,ux,ux,cb,ux,ux,ux,ur,ur,ux,ub,ug,ug,ub,ub,ub,ub,ur,ub,ub,ub
ux,ux,ur,ux,ux,ur,ux,ux,ux,ur,ur,ux,ub,cb,ub,ub,ub,ub,ub,ur,ub,ub,cb
cg,ux,ur,ux,ux,ur,ux,ux,ux,ur,ur,ub,ub,ub,ub,ub,ub,ub,ux,ur,ub,ub,ur
cb,ux,ur,ux,ub,ur,ub,ub,ux,ur,ur,ub,ub,ub,ub,ux,ux,ux,ux,ur,ub,ub,ub
ux,ug,ur,ux,ub,ur,ub,ub,ub,ub,ub,ub,cg,ub,ub,ub,ux,ux,ux,ur,ur,cr,cb
cb,ug,ur,ur,ur,ur,cr,cb,cr,ur,ur,cg,cb,ub,ub,ub,cr,ux,ux,cr,ur,cr,cb