ub,ub,cr,ur,ur,ur,ub,cb,cb,cb,cg,ur,cg,ur,ur,ur,cr,ug,ug,cb,cb,ur,cb
ub,cr,cr,ur,ur,ur,ub,ur,ur,ur,ur,ur,ur,ur,ur,ug,ur,ur,ug,ur,ur,ur,ur
cb,ur,ug,ug,ur,ur,ub,ur,ur,ur,ur,ur,cg,ug,ug,ug,ur,ur,ug,ur,ur,ur,ur
cg,ug,ug,ug,ur,ur,ub,ur,ur,ur,ur,ur,ur,ur,ur,ux,ux,ux,ug,ur,ur,ur,ur
ur,ug,cg,ur,ur,ug,ub,ur,ur,ur,ur,ur,ur,ur,ur,ux,ux,ux,ug,ur,ur,ur,ur
ur,ug,cg,cr,ug,ug,cb,ur,ur,ur,ur,ur,ur,ur,ur,ur,ur,ur,ug,ur,ur,ur,ur
ur,ur,ur,ur,ur,ur,ub,ur,ur,ur,ur,ur,ur,ur,ur,ur,ur,ur,ug,ur,ur,ux,ur
cr,ur,ur,ur,ur,ur,ur,ur,ur,ur,ur,ur,ur,ux,ur,ur,ur,ur,ug,ur,ur,ux,ur
ub,ur,ur,ur,ur,ur,ur,ux,ur,ur,ur,ur,ur,ur,ur,ug,ug,ug,ug,ug,ug,ug,ub
ur,ur,ur,ur,ur,cb,ub,ub,ub,ub,ub,ub,ub,ub,cr,ug,ug,ug,ug,ux,ux,ug,ub
ur,ur,ur,ur,ur,ur,ur,ur,ur,ur,ur,ur,ur,ub,ur,ug,ug,ug,ug,ug,ug,ug,ub
cg,ub,ub,ub,ub,ur,ux,ux,ux,ur,ur,ur,ur,ur,ur,ug,ug,ug,ug,ug,ug,ug,ug
ux,ux,ux,ux,ux,ur,ux,ux,ug,ub,ub,ug,ub,ug,ug,ub,ub,ub,ub,ub,ub,ub,ug
ux,ux,ux,ux,ux,ur,ux,ux,ug,ub,ub,ub,cb,ub,ug,cg,ug,ub,ug,ug,ug,ub,ug
ux,ux,ux,ux,ux,ur,ur,cr,ur,ub,ur,ub,ub,ug,ux,ux,ug,ug,ug,ub,ux,ub,ub
ux,ux,ux,ux,ux,ur,ux,ub,ur,ub,ux,ux,ux,ur,ux,ux,ub,ub,ub,ub,ux,ub,ub
ux,ux,ux,ux,ux,ub,ub,ub,ub,ub,ur,ur,ur,ur,ur,ur,ub,ux,ub,ub,ub,ub,ub
ux,ux,ux,ux,ux,ub,ub,ub,ub,ur,ux,ux,ux,ur,ux,ux,ub,ux,ub,ub,ub,ub,ub
ux,ux,ux,ux,ub,ub,ub,ub,ub,ur,ur,ur,ux,ur,ur,ux,ub,ux,ub,ub,ub,cb,cb
cg,ux,ux,ux,ub,ur,ux,ux,ub,ux,ux,ur,ur,ur,ur,ur,ub,ub,ub,ub,ub,ub,ur
cb,ux,ux,ux,ub,ub,ub,ub,ub,ux,ux,ux,ux,ur,ur,ur,ur,ur,ur,ur,ub,ub,ub
ux,ux,ux,ux,ux,ux,ux,ux,cb,ux,ux,ux,cg,ux,ur,ur,ur,ur,ur,ur,ux,cr,ux
ux,ux,ux,ux,ux,ux,cr,ux,cr,ux,cb,cg,cb,ux,ur,ur,cr,ux,ux,cr,ux,cr,cb