ur,ur,cr,ur,ur,ur,ur,cb,cb,cb,cg,cg,cg,ur,ur,ur,ur,ur,ur,ur,cb,cb,cb
ur,ur,ur,ur,ur,ur,ur,ur,ur,ur,ur,ur,ur,ur,ur,ur,ur,ur,ur,ur,ur,ur,ur
ur,cr,ur,cg,ug,ur,cr,ug,ur,ur,ur,ur,ur,ur,ur,ur,ur,ur,ur,ur,ur,ur,ur
cb,ur,ur,ug,cr,ur,ur,ug,ur,ur,ur,ug,ug,cb,ur,ur,ur,ur,ug,ux,ur,ur,ur
ur,ur,ur,cr,ur,ug,ug,cg,ug,ug,cr,ug,ug,ub,ub,ur,ur,ub,ub,ub,ux,ux,ur
ur,ub,ub,ur,ur,cg,ur,ur,ur,ug,ur,ur,cg,ub,ub,ur,ur,ub,ub,ub,ur,ux,ur
ur,ub,cb,ug,ug,ur,ur,ur,ug,ug,ug,ub,ub,ub,ub,ub,ub,ub,ub,ub,ur,ux,ur
ub,ub,cr,ug,ug,ur,ug,ug,ug,ug,ug,ur,ur,ub,ub,ub,ux,ub,ub,ub,ur,ux,ur
ub,ub,ug,ug,ur,ur,ug,ux,ux,ug,ur,ux,ub,ub,ug,ub,ub,ub,ux,cb,ur,ux,ur
ub,ub,ux,ux,ug,ur,ux,ux,ux,ug,ur,ub,ub,ub,ub,ub,ub,ux,ug,ur,ur,ur,ur
ub,ub,ub,ug,ug,ur,ug,ug,ug,ug,ur,ug,ug,ub,cb,ub,ub,ub,ub,ur,ub,ub,ub
ub,ub,ug,ug,ug,ur,ug,ug,ub,ub,ur,ub,ur,ub,ub,ub,ub,ub,ub,ur,ux,ux,ux
ub,ub,ub,ub,ub,ur,ub,ub,ub,ub,ur,ub,ub,ug,ub,ug,ug,ug,ub,ur,ux,ux,ux
ub,ub,ub,ux,ux,ur,ug,ug,ug,ub,ur,ug,ug,ug,ug,ug,ug,ug,cg,ur,ux,ux,ux
ub,ub,ub,ub,ub,ur,ug,ug,ug,ub,ur,ub,ub,ur,ug,ug,ux,ub,ub,ur,ux,ux,ux
ub,ub,ub,ub,ub,ur,ux,ux,ux,ub,ur,ub,ub,ub,ub,ub,ub,ub,ux,ur,ux,ux,ux
ub,ub,ux,ub,ub,ur,ux,ux,ux,ur,ur,ub,ub,ub,ub,ub,ub,ub,ub,ur,ux,ux,ux
ux,ux,ux,ux,ub,ur,ub,ub,ux,ur,ur,ux,ub,ub,ub,ub,ub,ub,ub,ur,ux,ux,ux
ux,ux,ub,ub,ub,ur,ux,ux,ux,ur,ur,ux,ub,ub,ub,ub,ub,ub,ub,ur,ux,ux,cb
cg,ux,ux,ux,ub,ur,ux,ux,ux,ur,ur,ub,ub,ub,ub,ub,ub,ub,ub,ur,ub,ub,ub
cb,ux,ux,ux,ux,ur,ux,ux,ux,ur,ur,ux,cb,ub,ub,ub,ub,ub,ub,ur,ub,ub,ub
ux,ux,ux,ux,ux,cr,ux,ux,ux,ur,ur,ux,cg,ub,ub,ub,ux,ux,ux,ur,ur,cr,cb
cb,ux,ux,ux,ux,ux,cr,ux,cr,ur,ur,cg,cb,ub,ub,ub,cr,ux,ux,cr,cr,cr,cb