ur,ur,cr,ur,ur,ur,ur,cb,cb,cb,cg,ur,cg,ur,ur,cb,ur,ur,ur,cb,cb,ur,cb
ur,ur,ur,ur,ur,ur,ur,cr,ur,ur,ur,ur,ur,ur,ur,ur,ur,ur,ur,ur,ur,ur,cb
ur,ur,ur,ur,ur,cr,ur,ur,ug,ug,ug,cr,ug,ur,ur,ur,ur,ur,ur,ur,ur,ur,ur
ur,ur,ur,ur,ur,ug,ur,ur,ur,ug,ub,ur,ug,ur,ur,ur,ur,ur,ur,ur,cr,ub,ub
ur,ur,ur,ur,ur,ug,ug,ur,ur,ug,ug,ur,ur,ur,ur,ur,ur,ur,ug,ur,cb,ub,ub
ur,ur,ur,ur,cg,ug,ug,ur,ur,ub,ub,ug,ug,ur,ur,ur,ub,ug,ug,ug,ub,ub,ub
ur,ur,ur,ur,ux,cr,ug,ur,ub,ub,ub,ub,ub,ur,ug,ur,ux,ub,ug,ug,ub,ub,ub
ux,ur,ur,ur,ur,ur,ug,ur,ur,ub,ur,ur,ub,ub,ug,ur,ur,ur,ub,ug,ub,ub,ub
ux,ur,ur,ur,ur,ur,ug,ur,ur,ub,ub,ub,ub,ur,ur,ux,ux,ur,ub,ub,cr,ur,ux
ux,ur,ux,ux,ux,ug,ug,ub,ur,ub,cb,ub,ub,ur,ug,ug,ug,ur,ur,cr,ub,ur,ub
ur,ur,ur,ur,ug,ug,ug,ug,ug,ux,ur,ux,ub,ur,ur,ur,ur,ur,ur,cb,ur,ur,ub
ur,ur,ux,ux,ug,ug,ug,ub,ug,ug,cg,ub,ub,ur,ur,ur,ur,ur,ur,ur,ur,ub,ub
ux,ux,ux,ug,ur,ub,ub,ub,ub,ug,ub,ub,ub,cb,ur,ur,ur,ur,ug,ug,ub,ub,ub
ux,ux,ux,ug,ur,ur,ur,ub,ug,ug,ur,ub,ub,ub,ux,ux,ub,ur,ug,ux,ux,ux,cg
ux,ux,ux,ub,ub,ub,ub,ub,ug,cg,ub,ub,ub,ub,ur,ur,ur,ur,ug,ub,ub,ub,ux
ux,ux,ux,ub,ux,ug,ux,ux,ux,ug,ug,ub,ub,ub,ur,ux,ux,ug,ug,ux,ux,ub,ub
ux,ux,ux,ub,ux,ux,ux,ux,ux,ux,ub,ub,ur,ub,ux,ux,ux,ug,ug,ux,ub,ub,ub
ux,ux,ux,ub,ux,ux,ux,ux,ux,ux,ux,ux,ur,ug,ug,ug,ug,ug,ug,ur,ur,ur,ur
cg,ux,ux,ub,ub,ub,ub,ub,ub,ub,ub,ub,ub,ub,ub,ub,cb,ug,ug,ur,ur,ur,ur
cg,ux,ux,ux,ux,ux,ux,ux,ux,ux,ux,ur,cg,ug,ug,ug,ur,ur,ur,ur,ur,ur,ur
cb,ur,ur,ur,ur,ur,ur,ur,ur,ur,ur,ur,ur,ur,ur,ur,ur,ur,ur,ur,ur,ur,ur
ux,ur,ux,ux,ux,ur,ur,ur,ur,ur,ur,ur,cg,ux,ux,ux,ux,ux,ux,ux,ux,cr,ur
ux,ur,ur,ur,ur,ur,cr,ux,cr,ux,ux,cg,cb,ux,ux,ux,cr,ux,ux,cr,ux,cr,cb