ur,ur,cr,ur,ur,ur,ur,cb,cb,cb,cg,ur,cg,ur,ur,cb,ur,ur,ur,cb,cb,ur,cb
ur,ur,ur,ur,ur,ur,ur,ur,ur,ur,ur,ur,ur,ur,ur,ur,ur,ur,ur,ur,ur,ur,cb
ur,ur,ur,ur,ur,ur,ur,ug,ug,ug,ug,ug,ug,ur,ur,ur,ur,ur,ur,ur,cr,cr,ux
cr,cr,ur,ur,ur,ur,ur,ug,ur,ug,ub,ur,ug,ur,ur,ur,ur,ux,ub,ub,ub,ub,ux
ug,ug,ug,ur,ur,ur,ug,ug,ur,ug,ug,ug,ug,ug,ug,ug,ug,ug,ug,ug,ur,ub,ur
ug,cg,ur,ur,ur,ur,ug,ub,ur,ub,ub,ug,ug,ur,ur,ur,ub,ug,ug,ug,ub,cb,ur
ur,ur,ur,ux,ux,ur,ug,ub,ub,ub,cb,ub,ug,ur,ug,ur,ux,ub,ug,ug,ub,ur,ux
ur,ur,ux,ux,ur,ur,ug,ub,ur,ub,ur,ur,ur,ur,ug,ur,ur,ur,ub,ug,ub,ub,ub
ur,ur,ur,ur,ur,ur,cg,ub,ur,ub,ub,ub,ub,ur,ur,ux,ux,ur,ur,ug,ub,ub,ux
ux,ur,ur,ur,ur,ur,ub,ub,ux,ux,ur,ux,ub,ur,ug,ug,ug,ug,ub,ug,ub,ub,ub
ur,ur,ur,ur,ur,ur,cr,ub,ux,ux,ur,ux,ub,cr,ub,ub,ux,ug,ub,ug,ub,cb,ub
ur,ur,ux,ux,ur,ub,ub,ub,ub,ub,cb,ug,ub,ub,ub,ug,ug,ug,ug,ug,ub,ub,ub
ux,ux,ux,ug,ur,ub,ub,ub,ub,ug,ub,cg,ub,ub,ur,ur,ur,ur,cg,ug,ub,ub,ub
ux,ux,ux,ug,ur,ur,ur,ub,ug,ug,ur,ub,ub,ub,ux,ux,ub,ur,ub,ur,ur,ux,cg
ux,ux,ux,ub,ub,ub,ub,ub,ug,ub,ur,ub,ub,ug,ur,ur,ur,ur,ub,ub,ub,ub,ux
ux,ux,ux,ub,ux,ug,ux,ux,ub,ub,ur,ur,cr,ur,ur,ux,ux,ug,ux,ux,ux,ub,ub
ur,ux,ux,ub,ux,ux,ux,ub,ub,ub,ub,ub,ur,ub,ub,ub,ub,ug,ub,ub,ub,ub,ub
ur,ur,ur,ub,ur,ur,ur,ur,ur,ur,ur,ur,ur,ug,ug,ug,ug,ug,ur,ur,ur,ur,ur
cg,ux,ux,cb,ux,ux,ux,ux,ux,ux,ux,ur,ur,ur,ur,ur,ur,ur,ur,ur,ur,ur,ur
cg,ux,ux,ux,ux,ux,ux,ux,ux,ux,ux,ur,ur,ur,ur,ur,ur,ur,ur,ur,ur,ur,ur
cb,ur,ur,ur,ur,ur,ur,ur,ur,ur,ur,ur,ur,ur,ur,ur,ur,ur,ur,ur,ur,ur,ur
ux,ur,ux,ux,ux,ur,ur,ur,ur,ur,ur,ur,cg,ux,ux,ux,ux,ux,ux,ux,ux,cr,ur
ux,ur,ur,ur,ur,ur,cr,ux,cr,ux,ux,cg,cb,ux,ux,ux,cr,ux,ux,cr,ux,cr,cb