ur,ur,cr,ur,ur,cr,ur,cb,cb,cb,cg,cg,cg,ur,ur,ur,ur,ux,ux,ux,cb,cb,cb
cg,ur,ur,ur,ub,cr,cr,ur,ur,ur,ur,ur,ur,ux,ux,ux,ur,ux,ux,ux,ux,ux,ux
ur,cr,ur,ur,cb,ur,ur,cb,ur,ur,ur,ur,ur,ur,ur,ur,ur,ur,ux,ux,ux,ux,ux
ur,ur,ur,ur,cr,ur,ur,ub,ur,ur,ur,ur,ur,cg,ug,ug,ug,ug,ug,ug,ux,ux,ux
ur,ur,ur,ur,ur,ur,ur,ub,ur,ur,ur,ur,ur,ur,ur,ur,ux,ur,ur,ug,ux,ux,ux
ur,ur,ur,ur,ur,ur,ur,ub,ur,ur,ur,ur,ur,ur,ur,ur,cb,ug,ug,ug,ur,ur,ur
ur,ur,ur,ur,ur,ur,ur,ub,ur,ur,ur,ur,ur,ur,cr,ub,ub,ur,ug,ug,ug,ur,ur
ub,ub,ub,ux,ux,ug,ub,ub,ub,ur,ur,ur,ur,ub,ub,ub,ub,ur,ug,ug,ug,ur,ur
ub,ub,ub,ux,ux,ug,ub,ub,ub,cr,ur,ub,ug,ub,ub,ub,ub,ur,ur,ur,ug,ur,ur
ub,ub,ub,ur,ux,ug,ub,ug,ug,ug,ug,ug,ug,ub,ug,cg,ub,ug,ub,ug,ug,ur,ur
ub,ub,ub,ub,ux,ug,ug,ug,ug,ub,cg,ug,ug,ub,ug,ug,ug,ug,ug,ug,ug,ug,ug
ub,ub,ub,ub,ux,ug,ug,ug,ug,ur,ub,ug,cb,ug,ug,ug,ug,ug,ug,ug,ug,ur,ur
ub,ub,ub,ub,ub,ug,ug,ug,ug,ug,ug,ug,ub,ub,ug,ub,ub,ug,ug,ug,ug,ug,ur
ub,cb,ux,ur,ug,ug,ug,ug,ux,ug,cb,ub,ug,ub,ub,ub,ug,ug,ur,ug,ux,ug,ur
ub,ur,ur,ur,ur,ur,ur,ug,ur,ur,ur,ur,ur,ur,ur,cr,ug,ug,ur,ug,ux,ux,ur
ub,ux,ur,ux,ug,ug,cg,ug,ux,ux,ux,ug,ug,ug,ug,ug,ur,ug,ur,ur,ur,ur,ur
ub,ux,ur,ux,ug,ug,ux,ur,ux,ux,ux,ux,ug,ug,ug,ug,ur,ux,ur,ur,ux,ux,ux
ub,ub,ur,ub,ug,ug,ux,ur,ux,ux,ux,ux,ug,ug,ub,ug,ur,ub,ur,ur,ux,ux,ux
ux,ux,ur,ux,ux,ub,ub,ur,ub,ub,ub,ug,ug,ub,ux,ug,ug,ux,ur,ur,ux,ux,cb
cg,ux,ur,ux,ux,ux,ux,ur,ux,ux,ux,ug,ug,ug,ug,ug,ug,ux,ur,ur,ux,ux,ux
cb,ux,ur,ur,ur,ur,ur,ur,ux,ux,ux,ux,ux,ux,ux,ug,ug,ug,ug,ur,ux,ux,ux
ux,ux,ux,ux,ux,ux,ux,ux,ux,ux,ux,ux,cg,ux,ux,ug,ug,ug,ug,ur,ux,cr,cb
cb,ux,ux,ux,ux,ux,cr,cb,cr,ux,ux,cg,cb,ux,ux,ux,cr,ux,ux,cr,ux,cr,cb