cr,ur,cr,ur,ub,ub,cb,cb,cb,cb,cg,cg,cg,ux,ux,ux,ur,ur,ur,ur,cb,cb,cb
cg,ur,ur,ur,cr,ur,ur,ur,ur,ur,ur,ur,ur,ur,ur,ur,ur,ur,ur,ur,ux,ux,ux
cr,cr,ur,ur,ur,ur,ur,ur,ur,ur,ur,cb,ub,ur,ur,ur,ur,ur,cr,ux,ux,ux,ux
ur,ur,ur,ux,ur,ur,ur,ux,ur,ur,ur,ur,ub,ur,ur,cr,cr,ub,ub,ub,ub,ub,ux
ux,ux,ur,ux,ux,ux,ux,ur,ur,ur,ur,ur,ub,ur,ur,ur,ux,ux,ub,ux,ux,ux,ux
ux,ux,ur,ur,ur,ur,ur,ur,ur,ur,ux,ur,ub,ux,ux,ux,ux,ux,ub,ux,ux,ux,ux
ux,ux,ur,ur,ur,ur,ur,ur,ur,ur,ur,ur,ub,ux,ux,ux,ux,ux,ub,ux,ux,ux,ux
ux,ux,ux,ux,ur,ur,ur,ur,ux,ux,ux,ux,ub,ux,ux,ux,ux,ux,ub,ux,ux,ux,ux
ux,ux,ux,ux,ur,ux,ux,ub,ub,ub,ub,ub,ub,ux,ux,ux,ux,ux,ub,cg,ug,ug,ux
ux,ur,ur,ur,ur,ux,ub,ub,ub,ub,ub,ub,ub,ug,ug,ux,ux,cb,ug,ug,ug,ux,ux
ux,ux,ux,ux,ux,ug,ub,ub,ub,ub,ub,ub,ub,ug,ug,ux,ux,ub,ux,ug,ug,ux,ux
ux,ux,ux,ux,ux,ug,ub,ub,ug,cb,ux,ux,ux,ug,ug,ux,ug,ub,ug,ug,ug,ug,ux
ux,ux,ux,ux,ux,ug,ug,ux,ug,ux,ux,ux,ux,cg,ug,ub,ub,ub,ug,ug,ux,ug,ux
ux,ux,ux,ux,ux,ug,ug,ux,ug,ub,cb,ug,ug,ux,ux,ub,ug,ug,ug,ug,ug,ug,ux
ux,ux,ur,ur,ur,ug,ug,ug,ug,ug,cg,ug,ug,ux,ux,ub,ux,ux,ux,ux,ux,ux,ux
ux,ux,ur,cr,ur,ug,ug,ug,ug,ux,ug,ug,ug,ux,ux,ub,ux,ux,ux,ux,ux,ux,ux
ux,ux,ur,ur,cg,ug,ux,ug,ug,ux,ug,ug,ux,ux,ux,ub,ux,ux,ux,ux,ux,ux,ub
ux,ux,ur,ur,ug,ug,ur,ur,ur,ur,ug,ug,ub,ub,ub,ub,ub,ub,ub,ub,ub,ub,ub
ux,ux,ur,ur,ug,ug,ug,ug,ug,ug,ug,ug,ub,ub,ub,ub,ux,ux,ux,ux,ux,ux,cb
cg,ux,ur,ur,ug,ug,ux,ub,ub,ux,ug,ux,ux,ux,ux,ux,ux,ux,ux,ux,ux,ux,ux
cb,ux,ur,ur,ur,ur,ur,ub,ub,ur,ur,ur,ur,ur,ur,ur,ur,cr,ux,ux,ux,ux,ux
ux,ux,ur,ux,ur,ub,ub,ub,ub,ub,ub,ux,cg,ux,ux,ux,ux,ux,ux,ux,ux,cr,cb
cb,ub,ur,ur,ur,ub,cr,cb,cr,ux,cb,cg,cb,ux,ux,ux,ux,ux,ux,cr,ux,cr,cb