ur,ur,cr,ur,ur,ur,ur,cb,cb,cb,cg,ur,cg,ur,ur,ur,ur,ur,ur,cb,cb,ur,cb
ur,ur,ur,ur,ug,ug,ug,ur,ur,ur,ur,ur,cr,cr,ur,ur,ur,ur,ur,ur,ur,ur,ur
ur,ur,ur,cr,cg,ug,ug,ur,ur,ur,ur,ub,ub,ur,ur,ur,cr,ux,ur,ur,ur,ur,ur
cg,ur,ur,ug,ug,ug,ur,ur,ur,ur,ur,ux,ub,cb,ur,ur,ur,ur,ur,ur,ur,ur,ur
ur,ur,ug,ur,ug,ug,ur,ur,ug,ug,ux,ux,ub,ur,ur,ur,ur,ur,ur,ur,ur,ur,ur
ur,ur,ug,ur,ur,cg,ur,cr,ug,ug,ug,ug,ub,ug,ur,ur,ur,ux,ux,ux,ux,ux,ux
ur,ur,ug,ug,ug,ug,ur,ur,ur,ur,ux,ux,ub,ux,ub,ub,ur,ub,ub,ub,ub,ub,ur
ur,ux,ug,ug,ug,ur,ur,ur,ur,ur,ux,ux,ub,ub,ub,ub,ur,ub,ub,ub,ub,ub,ur
ur,ur,ur,ur,ur,ur,ur,ug,ub,ub,ux,ux,ux,ub,ux,ub,ur,ux,ux,ux,ux,ux,ux
ur,ur,ug,ug,cg,ur,ur,ub,ub,ub,ub,ub,ub,ub,ub,ub,ur,ux,ux,ux,ux,ux,ux
ur,ur,ug,ug,ug,ug,ug,ug,ub,ub,ub,ur,ub,ub,ub,ub,ur,ur,ur,ur,ur,ur,ur
cg,cb,ub,ub,ub,ub,ub,ub,ub,ub,cg,ug,ub,ub,ub,ub,ub,ub,ub,ub,ub,ub,ur
ur,ur,ur,ug,ub,ub,ug,ug,ub,ub,ux,ug,ub,ug,ub,ug,ug,ub,ub,ub,ub,ub,ur
ur,ur,ur,ub,ub,ub,ub,ug,ug,ub,ux,ug,ug,ug,cb,ug,ug,ug,ub,ub,ux,ub,ur
ux,ub,ub,ub,ub,ug,ug,ug,ub,ub,ug,ug,ug,ug,ux,ug,ug,ug,ub,ub,ux,ub,ur
ux,ub,ur,ur,ub,ug,ub,ub,ub,ub,ub,ub,ub,cb,ug,ug,ug,ux,ux,ux,ux,ub,ur
ux,ub,ur,ub,ub,ux,ux,ur,ub,ur,ux,ug,ug,ug,cr,ur,ur,cb,ub,ub,ub,ub,ur
ux,ub,ur,ub,ur,ur,ur,ur,ur,ur,ub,ub,ub,ur,ur,ur,ur,ur,ur,ur,ur,ur,ur
ux,ub,ur,ub,ub,ub,ub,ub,ub,ux,ub,ub,ux,cr,ux,ux,ux,ux,ux,ux,ux,ux,cb
cg,ub,ub,ub,ub,ur,ux,ur,ub,ux,ub,ub,ux,ux,ux,ux,ux,ux,ux,ux,ux,ux,ux
cb,ur,ur,ur,ub,ub,ub,ur,ub,ux,ub,ub,ux,ux,ux,ux,ux,ux,ux,ux,ux,ux,ux
ur,ur,ur,ur,ub,ur,ur,ur,cb,ux,ub,ub,cg,ux,ux,ux,ux,ux,ux,ux,ux,cr,ux
ur,ur,ur,ub,ub,ux,cr,ux,cr,ux,cb,cg,cb,ux,ux,ux,cr,ux,ux,cr,ux,cr,cb