cr,ur,cr,ur,ur,cb,ur,cb,cb,cb,ur,cg,cg,ur,ur,ur,ub,ur,ur,ur,cb,cb,cb
ug,ug,ug,cg,ur,ur,ur,ur,ur,ur,ur,ur,ur,ub,ub,ub,ub,ub,ub,ub,ub,ub,ub
ug,cr,ug,cr,ur,ur,ur,ur,ur,ur,ur,ur,ur,ub,ub,ub,ub,ub,ub,ub,ub,ub,ub
ub,ub,ur,ur,ur,ur,ur,ur,ur,ur,ur,ug,ur,ur,ur,ur,ur,ur,ur,ur,ur,ur,ur
ub,cb,ug,ug,ur,ug,ub,ug,ur,ur,ur,ug,ur,ur,ur,ur,cg,ug,ug,ur,ur,ur,ub
cg,ub,ub,ub,ub,ub,ub,ug,ur,ur,ur,ur,ur,ug,ug,ug,ug,ug,ug,ur,ur,ub,ub
cg,ug,ug,ug,ub,ur,ub,ug,ur,ur,ur,ur,ur,ug,ur,ug,ug,ug,ub,ur,ur,ur,ur
ug,ug,ug,ub,ub,ur,ub,ug,ur,ug,ug,ur,ur,ug,ub,ug,ub,ug,ug,ur,ur,ur,ur
ug,ug,ug,ub,ub,ub,ub,ug,ur,ug,ug,ur,ur,ug,ug,ug,ur,ug,ur,ur,ub,ur,ur
ug,ug,ub,ub,ub,cb,ub,ub,ub,ug,ug,ug,ub,ug,cr,ug,ub,ug,ug,ug,ub,ur,ur
cg,ug,ur,ur,ur,ur,ur,ur,ur,ur,ub,ug,ug,ug,ur,ug,ug,ur,ur,ug,ur,ur,ur
ug,ug,ur,ub,ub,ub,ub,ub,ub,ur,ub,ug,ub,ub,ur,ug,ub,ur,ub,ug,ub,ur,ur
ug,ug,ur,ur,ur,ub,ub,ub,ub,ur,ur,ur,ur,ur,ur,ug,ug,ur,ug,ug,ub,ub,ur
ug,ug,ub,ub,ur,ub,ub,ub,ub,ug,ub,ug,ug,ur,ug,ug,ug,ur,ub,ub,ub,ub,ub
cg,ug,ug,ug,ur,ub,ub,ur,ur,ug,ug,ug,ug,ug,ug,ug,ur,ur,ug,ug,ub,ub,cb
cb,ub,ub,ub,ub,ub,ub,ug,ur,ug,ug,ug,ug,ug,ug,ug,ug,ug,ug,ug,ub,ub,ur
ub,ug,ur,ug,ug,ur,ur,ug,ur,ug,ur,ug,ub,ur,ub,ug,ur,ub,ug,ug,ub,ub,cr
ub,ug,ur,ug,ug,ug,ug,ug,ur,ug,ug,ug,ug,ug,ug,ug,ug,ug,cb,ug,ub,ub,ub
ub,ug,ur,ub,ug,ug,ug,ug,ub,ur,ur,ug,ur,ug,ug,ug,ug,ug,ub,ub,ub,ur,ub
ub,ub,ub,ub,ug,ug,ug,ug,ub,ur,ur,ug,ur,ub,ub,ub,ub,ub,ub,ub,ub,ub,ub
cb,cb,ub,ub,ug,ug,ug,ug,ub,ur,ur,ug,ur,ur,ub,ur,ub,ur,ub,ub,ub,ur,ug
ug,ug,ug,ug,ug,ug,ug,ug,ug,ur,ur,ug,cg,ur,ub,ur,ub,ur,ub,ub,ub,cr,cb
cb,ug,ug,ug,ug,ug,cr,ug,cr,ur,ur,cg,cb,ur,ub,ub,ub,ub,ub,cr,ub,cr,cb