ur,ur,cr,ur,ur,ur,ur,cb,cb,cb,cg,ur,cg,ur,ur,cb,ub,ub,ur,cb,cb,ur,cb
ur,ur,ur,ug,ug,ug,ur,ub,cb,ur,ur,ur,ub,cb,ur,cr,ub,ub,ur,ur,ur,ur,cb
ur,ur,cr,ug,ug,cg,ur,cr,ur,cr,ub,ub,ub,ur,ur,ur,ub,ub,ub,ub,ur,ur,ux
ur,ur,ug,ug,ug,ur,ur,cr,ur,ug,ub,ur,ur,ur,ur,ur,ub,ur,ub,ub,ub,ub,ux
ur,ur,ur,ur,ur,ur,ub,ub,ur,ug,ug,ug,ur,ur,ur,ug,ub,ur,ub,ur,ur,ur,ur
ur,ur,ur,ur,ur,ur,ur,ub,ur,ub,ur,cg,ur,ur,ur,ub,ub,ug,ug,ur,ub,ub,cr
ur,ur,ur,ur,ur,ur,ug,ug,ur,ur,ur,cb,ub,ub,ub,ub,ux,ub,ug,ur,ub,ub,ux
ur,ur,ur,ur,ur,ur,ug,ux,ur,ub,ur,ur,ur,ug,ur,ur,ur,cg,ur,ub,ub,ub,cb
ur,ur,ur,ur,ur,ur,ug,ur,ur,ub,ur,ux,ug,ug,ur,ux,ux,ug,ug,ub,ub,ub,ux
ux,ur,ur,ur,ur,ur,ug,ux,ux,ug,ur,ug,ug,ub,ug,ug,ug,ug,ub,ub,ub,ub,ub
ur,ur,ur,ur,ur,ur,ux,ux,ub,ux,ur,ux,ub,ug,ug,ub,ux,ug,ub,ub,ub,ub,ub
ur,ur,ux,ux,ux,ug,ux,ug,ug,ub,ub,ub,ub,cb,ug,ug,ug,ug,ug,ub,ub,ub,ub
ux,ux,ux,ug,ug,ug,ug,ug,ug,ug,ub,ub,ub,ub,ur,ur,ur,ur,ub,ub,ub,ub,ub
ux,ux,ux,ug,ug,ux,cg,ug,ug,ug,ur,ub,ub,ub,ux,ux,ub,ur,ub,ur,ur,ux,cg
ux,ux,ux,ug,ug,ug,ug,ug,ug,ub,ur,ub,ub,ug,ur,ur,ur,ur,ub,ub,ub,ub,ux
ux,ux,ux,ux,ux,ug,ub,ub,ub,ub,ur,ur,ur,ur,ur,ux,ux,ug,ux,ux,ux,ub,ub
ur,ur,ur,ur,ur,ub,ub,ub,ub,ub,ub,ub,ub,ub,ub,ub,ub,ug,ub,ub,ub,ub,ub
ur,ur,ur,ur,ur,ur,ur,ur,ur,ur,ur,ur,ug,ug,ug,ug,ug,ug,ur,ur,ur,ur,ur
cg,ux,ux,ux,ux,ux,ux,ux,ux,ux,ux,ur,ur,ur,ur,cr,ux,ux,ux,ux,ux,ux,ur
cg,ux,ux,ux,ux,ux,ux,ux,ux,ux,ux,ur,ux,ux,ux,ux,ux,ux,ux,ux,ux,ux,ur
cb,ur,ur,ur,ur,ur,ur,ur,ur,ur,ur,ur,ur,ur,ur,ur,ur,ur,ur,ur,ur,ur,ur
ux,ur,ux,ux,ux,ur,ur,ur,ur,ur,ur,ur,cg,ux,ux,ux,ux,ux,ux,ux,ux,cr,ur
ux,ur,ur,ur,ur,ur,cr,ux,cr,ux,ux,cg,cb,ux,ux,ux,cr,ux,ux,cr,ux,cr,cb