cb,ub,cr,ur,ur,cr,ux,cb,cb,cb,cg,cg,cg,ur,ur,ur,ur,ur,ur,ur,cb,cb,cb
cg,ub,ur,ur,ur,ur,ur,ur,ur,ur,cb,ur,ur,ur,ur,ur,ur,ur,ur,ur,ur,ur,ur
ux,cr,ur,ur,ur,ur,ur,ur,ur,ur,ub,ur,ur,ur,ur,ur,ur,ur,ur,ur,ur,ur,ur
ux,ux,ur,ur,ur,ur,ur,ur,ur,ur,ub,ub,ub,cr,ur,ur,ur,ur,ur,ur,ur,ur,ux
ux,ux,ur,ur,ur,ur,ur,ur,ur,ur,ur,ur,ur,ur,ur,ur,ur,ur,ur,ug,ur,ur,ux
ux,ux,ur,ur,ur,ur,ur,ur,ur,ur,ur,ur,ug,ur,cr,ur,ur,cr,ur,ux,ux,ux,ux
ur,ur,ug,ug,ug,ug,ug,ug,ug,cg,ur,ur,ur,ur,ub,ub,ub,ux,ux,ux,ux,ux,ux
ur,ur,ug,ur,ur,ur,ur,ur,ur,cr,ug,ub,ub,ug,ub,ub,ub,ug,ug,ux,ux,ux,ux
ug,ug,ug,ur,ur,ur,ur,ur,ur,ug,ug,ub,ub,ub,ub,ub,ub,ub,ug,ux,ug,ug,ug
ug,ur,ur,ur,ur,ur,ur,ug,ub,ub,ub,ub,ug,ug,ug,ug,ub,ub,ux,ux,ug,ux,ug
ug,ur,ur,ur,ur,ur,cb,ug,ub,ub,cg,ug,ug,ug,ug,ug,ub,ug,ux,ug,ug,ug,ug
ug,ug,ug,ug,ug,ug,ub,ub,ub,ub,ub,ub,ub,ub,ub,ub,cb,ub,cg,ug,ug,ug,ug
ur,ur,ur,ug,ug,ux,ug,ug,ug,ug,ug,ug,ub,ub,ub,ub,ub,ub,ux,ux,ug,ug,ug
cr,ug,ug,ug,ug,ug,ug,ug,ug,ug,cb,ub,cg,ub,ub,ub,ub,ub,ug,ux,ug,ug,ug
ur,ur,ur,ur,ur,ur,ur,ur,ug,ug,cr,ug,ug,ub,ub,ub,ub,ub,ug,ux,ug,ug,ug
ur,ur,ur,ur,ur,ur,ur,ur,ug,ug,ur,ug,ub,ub,ub,ub,ug,ug,ug,ug,ug,ug,ug
ux,ub,ub,ub,ub,ux,ug,ur,ur,ur,ur,ug,ug,ux,ug,ur,ux,ux,ux,ux,ux,ux,ux
ub,ub,ub,ub,ub,ux,ux,ux,ux,ur,ur,ux,ug,ux,ug,ur,ux,ux,ux,ux,ux,ux,ux
ub,ub,ub,ub,ub,ux,ux,ux,ux,ur,ur,ux,ug,ug,ug,ur,ux,ux,ux,ux,ux,ux,cb
cg,ub,ub,ub,ub,ux,ux,ux,ux,ur,ur,ux,ux,ux,ur,ur,ux,ux,ux,ux,ux,ux,ux
cb,ub,ub,ux,ub,ub,cb,ux,ux,ur,ur,ux,ux,ux,ur,ur,ux,ux,ux,ux,ux,ux,ux
ux,ub,ub,ub,ub,ub,ux,ux,ux,ur,ur,ux,cg,ux,ur,ur,ux,ux,ux,ux,ux,cr,cb
cb,ux,ub,ub,ub,ux,cr,cb,cr,ur,ur,cg,cb,ux,ur,ur,cr,ux,ux,cr,ux,cr,cb