ur,ur,cr,ur,ur,ur,ur,cb,cb,cb,cg,cg,cg,ur,ur,ur,ur,cr,ur,ur,cb,cb,cb
ur,ur,ur,ur,ur,ur,ur,ur,ur,ur,ur,ur,ur,ur,ur,ur,ur,ub,ur,ur,ur,ur,ur
ur,cr,ug,ur,cr,ug,ur,ur,ur,ur,ur,ur,ur,ur,ur,ur,ur,ur,ur,ur,ur,ur,ur
cb,ur,cg,ur,ur,cr,cr,ur,ur,ur,ur,ur,ur,ur,ur,ur,ur,ur,ur,ur,ur,ur,ur
ur,ur,ur,ug,ug,cg,ur,ur,ur,ur,ur,ur,ur,ur,ur,ur,ur,ur,ur,ux,ux,ur,ur
ur,ur,ur,ur,ug,ug,ur,cb,ub,ub,ub,ur,ur,ur,cr,ux,ux,ux,ur,ur,ur,ur,ur
ur,ur,ur,ur,ur,ur,ub,ub,ub,ub,cb,ub,ub,ur,ux,ux,ux,ux,ur,ur,ux,ux,ur
ur,ur,ur,ur,ur,ur,ub,ug,ug,ub,ug,ug,ub,ub,ub,ur,ux,ux,ur,ur,ur,ur,ur
ur,ur,ur,ur,ur,ug,cg,ug,ug,ug,ug,ug,ug,ub,ub,ur,ux,ub,ur,ur,ur,ur,ur
ur,ur,ur,ur,ug,ug,ug,ug,ug,cg,ur,ug,ug,ug,ug,ug,ug,ug,ug,ug,ug,ux,ub
ur,ur,ux,ux,ur,ur,ur,ug,ug,ug,ug,ug,ug,ug,ug,ub,ug,ug,ug,ug,ug,cg,ub
ur,ur,ur,ur,ur,ur,ur,ug,ug,ug,ug,ug,ub,ub,ug,ug,ug,ug,ug,ug,ug,ug,ur
ur,ur,ur,ur,ur,ur,ur,ur,ur,ur,ur,ur,ub,ux,ug,ug,ux,ug,ug,ug,ug,ug,ur
ux,ux,ux,ux,ux,ur,ur,ur,ur,ur,cb,ux,ub,ub,ug,ug,ug,ug,ug,ug,ug,ug,ur
ux,ur,ur,ur,ur,ub,ub,ub,ur,ur,ur,ur,ur,ub,ub,ub,ub,ug,ug,ug,ug,ux,ur
ux,ux,ux,ur,ur,ub,ub,ub,ub,ub,ub,ub,ub,ub,ub,ub,ub,ur,ur,ur,ur,ur,ur
ux,ur,ur,ur,ur,ur,ur,ub,ub,ub,ux,cb,ub,ub,ub,ub,ub,ux,ux,ux,ub,ux,ux
ux,ur,ur,ur,ur,ur,ur,ur,ur,ub,ub,ub,ub,ub,ub,ub,ub,ub,ub,ub,ub,ux,ux
ux,ux,ux,ux,ux,ub,ub,ub,ub,ub,ub,ux,ub,ub,ur,ub,ub,ub,ub,ub,ub,ux,cb
cg,ux,ux,ux,ux,ub,ub,ub,ub,ub,ux,ux,ub,ub,ur,ub,ux,ux,ux,ux,ub,ux,ux
cb,ux,ux,ux,ux,ux,ub,ub,cb,ub,ub,ub,ux,ux,cb,ub,ux,ub,ub,ub,ub,ux,ux
ux,ux,ux,ux,ux,ux,ub,ub,ub,ub,ub,ub,cg,cr,ur,ur,cr,ux,ux,ux,ux,cr,cb
cb,ux,ux,ux,ux,ux,cr,ub,cr,ub,ub,cg,cb,ur,ur,ur,cr,ux,ux,cr,ux,cr,cb