ur,ur,cr,ur,ur,ur,ur,cb,cb,cb,cg,cg,cg,ur,ur,ur,ur,ur,ur,ur,cb,cb,cb
ur,ur,ur,ur,ur,ur,ur,ur,ur,ux,ux,ux,ux,ur,ur,ur,ur,ur,ur,ur,ur,ur,ur
ur,cr,ur,ur,ur,ur,ur,ur,ur,ux,ux,ux,ux,ur,ur,ur,ur,ur,ur,ur,ur,ur,ur
cb,ur,ur,cg,ur,ur,cr,ur,ur,ur,ur,ur,ur,ur,ur,ur,ur,ur,ur,ur,ur,ur,ur
ur,cr,ur,ug,ur,cg,ur,ur,ur,ur,ur,ub,ub,ub,ub,ub,ub,ur,ur,ur,ur,ur,ur
ur,ur,ur,cr,cr,ug,cr,ur,ub,ub,ub,ub,ub,ub,cb,ur,ub,ur,ur,ur,ur,ur,ux
ur,ur,ur,ur,ur,ur,ur,ur,ub,ub,ub,ub,ub,ub,ub,ub,ub,ur,ur,ur,ur,ur,ux
ur,ur,ur,ur,ur,ux,ur,ur,ur,ur,ur,ur,ur,ur,ur,ur,ur,ur,ug,ug,ux,ur,ux
cb,ub,ub,ub,ur,ur,ux,ur,ur,ur,cg,ur,ub,ug,ug,ug,ur,ur,ug,ug,ur,ur,ux
ux,ux,ux,ub,ur,ur,ux,ur,ur,ur,ug,ub,ug,ug,ug,ug,ug,ug,cg,ug,ur,ur,ux
ux,ux,ux,ub,ur,ur,ur,ur,ur,ug,ug,ub,ur,ur,ug,ug,ug,ug,ug,ug,ur,ur,ux
ux,ux,ux,ub,ub,ub,ub,ub,ub,ug,ub,ug,ug,ug,ug,ug,ug,ug,ug,ug,ur,ur,ux
ux,ux,ux,ux,ux,ux,ux,ub,ux,ug,ug,ug,ug,ug,ug,ug,ug,ug,ug,ug,ug,ur,ux
ux,ux,ux,ux,ux,ux,ux,ub,ub,ug,ug,ug,ub,ub,ux,ug,cg,ug,ur,ug,ur,ur,ux
ux,ux,ux,ux,ux,ux,ux,ux,ub,ux,ub,ug,ux,ub,ub,ug,ug,ug,ur,ug,ug,ur,ux
ux,ux,ux,ux,ux,ux,ub,ub,ub,ux,ux,ug,ux,ub,ub,ug,ug,ub,ur,ur,ur,ur,ux
ux,ux,ux,ux,ux,ux,ub,cr,ur,ur,ur,ur,ur,ur,ur,ur,ur,ur,ur,ub,ur,ur,ux
ux,ux,ux,ux,ux,ux,ub,ub,ub,ub,ux,ug,ub,ub,ub,ub,ur,ur,ur,ur,ur,ur,ux
ux,ux,ux,ux,ux,ux,ub,ub,ub,ub,ub,ug,ug,ug,ug,ug,ug,ur,ub,ub,ur,ub,cb
cg,cr,ur,ur,ur,ur,ur,ur,ur,ur,ur,ur,ur,ur,ur,ur,ur,ur,ur,ur,ur,ub,ub
cb,ux,ux,cb,ub,ub,ub,ub,ub,ub,ux,ub,ub,ug,ug,ug,ug,ur,ub,ub,ur,ub,cb
ux,ux,ux,ux,ub,ub,ux,ub,ub,ux,ux,ub,cg,ub,ug,ug,ug,ug,ur,ur,ur,cr,cb
cb,ux,ux,ux,ux,ub,cr,cb,cr,ux,ux,cg,cb,ub,ub,ub,cr,ur,ur,cr,ur,cr,cb