ur,ur,cr,ug,cr,ur,ur,cb,cb,cb,cg,cg,cg,ur,ur,ur,ur,ur,ux,ux,cb,cb,cb
ur,ur,ur,cg,ur,ur,ur,ur,ur,ur,ur,ur,ur,ub,ub,ub,ur,ur,ux,ux,ux,cr,ux
ur,cr,ur,ur,ur,cr,ur,ur,ur,ur,ur,ur,ur,ux,ux,ub,ub,ub,ub,ub,ux,ur,ux
cb,ur,ur,ur,ur,ur,ur,ur,ur,ur,ur,ug,ug,ub,ub,ub,ub,ub,ub,ub,ux,cb,ux
ur,ur,cr,ug,ug,ur,ur,ur,ur,ur,ur,ug,ug,ub,ub,ur,ur,ub,ub,ub,ux,ub,ux
ur,ur,ur,ur,ug,cg,ub,cb,ur,ur,ur,ug,ug,ub,ub,ur,ur,ub,ub,ub,ur,ub,ux
ur,ur,ur,ur,ur,cr,ub,ur,ur,ur,ug,ug,ub,ub,ub,ub,ub,ub,ub,ub,ur,ub,ux
ur,ur,ur,ur,ur,ug,cr,ur,ur,ug,ug,ug,ug,ub,ub,ub,ub,ub,ub,ub,ur,ub,ux
ur,ur,ur,ur,ur,ur,ur,ur,ux,ux,ur,ux,ug,ub,ub,ub,ug,ug,ug,ug,ub,ub,ux
ur,ur,ur,ur,ug,ug,ug,ux,ux,ux,ur,ux,ux,ub,ub,ub,ug,ug,ug,ug,ur,ub,ux
ur,ur,ur,ur,cg,ub,ux,ux,ux,ux,ur,ux,ux,ug,ub,ug,ug,ug,ug,ug,ub,ub,ub
ur,ur,ur,ur,ur,ub,ux,ux,ux,ux,ur,ux,ux,ug,ug,ug,ug,ug,ug,ug,ur,ub,ub
ub,ub,ur,ur,ux,ub,ux,ux,ux,ux,ur,ux,ug,ug,cg,ub,ug,ug,ug,ug,ur,ub,ub
ub,ub,ug,ux,cb,ub,ux,ux,ux,ux,ur,ux,ug,ug,ug,ug,ug,ug,ug,ug,ur,ub,ub
ub,ux,ur,ur,ub,ur,ur,cr,ux,ux,ur,ux,ux,ub,ug,ux,ug,cg,ub,ur,ur,ub,ub
ub,ub,ur,ux,ub,ub,ux,ux,ux,ux,ur,ub,ub,ub,ub,cb,ug,ub,ux,ur,ur,ub,ub
ux,ub,ur,ux,ub,ub,ux,ux,ux,ux,ur,ub,ub,ub,ub,ub,ub,ub,ub,ur,ur,ub,ub
ux,ux,ur,ux,ub,ub,ux,ux,ux,ux,ur,ux,ub,ub,ub,ub,ub,ub,ub,ur,ub,ub,ub
ux,ux,ur,ux,ub,ub,ux,ux,ux,ux,ur,ux,ub,ub,ub,ub,ub,ub,ub,ur,ub,ub,cb
cg,ux,ur,ux,ux,ur,ux,ux,ux,ux,ur,ub,ub,ub,ub,ux,ux,ux,ux,ur,ub,ub,ur
cb,ux,ur,ux,ub,ur,ub,ub,ux,ux,ur,ub,ub,ub,ub,ux,ux,ux,ux,ur,ub,ub,ub
ux,ug,ur,ux,ub,ur,ub,ub,ub,ub,ub,ub,cg,ub,ub,ux,ux,ux,ux,ur,ur,cr,cb
cb,ug,ur,ur,ur,ur,cr,cb,cr,ux,ur,cg,cb,ub,ub,ub,cr,ux,ux,cr,ur,cr,cb