ug,ug,cr,ur,ur,ur,ur,cb,cb,cb,cg,ur,cg,ur,ur,ur,ur,ux,ux,cb,cb,ux,cb
cr,cg,ur,ur,ur,ur,ur,ur,ur,ur,ur,ur,cr,ur,ur,ur,ur,ur,ux,ux,ux,cb,cb
ur,ur,cr,ug,ur,ur,ur,ur,ur,ur,ur,ur,ur,ur,ur,ur,ur,ur,ur,ur,ux,ur,ur
cg,ug,ur,ur,ur,ur,ur,ur,ur,ur,ur,ur,ub,ub,ub,ur,ur,ur,ur,ur,ur,ur,ur
ux,ug,cg,ug,ug,ug,ur,ur,ur,ur,ur,ur,ur,ur,ub,ur,ur,ur,ur,ur,ur,ur,ur
ux,ur,ur,ur,cr,ug,ur,ur,ur,ur,ur,ug,ur,cr,ur,ur,ur,ur,ur,ur,ur,ur,ux
ux,cb,ub,ub,ub,cg,ug,ur,ug,ug,ug,ug,ub,ub,ub,ub,ub,ub,ub,ub,ur,ur,ur
ub,ub,ub,ub,ub,ub,ug,ug,ug,ub,ur,ub,ub,ub,ub,ub,ug,ug,ug,ur,ur,ux,ur
ub,ux,ux,ux,ug,ub,ub,ur,ur,ub,ur,ux,ux,ux,ux,ux,ux,cb,ux,ub,ur,ur,ur
ub,ux,ux,ux,ux,ub,ub,ub,ub,ub,ub,ub,ub,ub,ub,ub,ux,ub,ug,ub,ur,ur,ur
ub,ux,ux,ux,ux,ub,ub,ug,ug,ub,ub,ug,ug,ug,ug,ub,ug,cg,ug,ug,ug,ur,ub
ub,ub,ub,ub,ub,ub,ub,ub,ub,ub,ub,ub,ug,ug,ug,ug,ug,ug,ub,ub,ub,ub,ub
ub,ub,ub,ux,ub,ub,ub,ug,ub,ub,ub,ub,ub,ub,ub,ub,ug,ub,ub,ub,ub,ub,ub
ub,ub,ub,ub,ub,ub,ub,ub,ub,ug,ub,ub,ub,ub,ub,ub,ug,ub,ub,ub,ub,ur,ur
ub,ub,ub,ub,ub,cb,ux,ux,ug,cg,ug,ux,ug,ub,ub,ug,ug,ub,ub,ub,ub,ur,ub
ub,ub,ub,ub,ub,ur,ux,ux,ug,ug,ug,ug,ug,cb,cb,ug,ug,ub,ub,ub,ub,ur,ub
ub,ub,ux,ux,ux,ur,ux,ux,ug,ug,ug,ub,ub,ub,ub,ug,ug,ub,ub,ur,ur,ur,ur
ub,ub,ux,ux,ux,cr,ux,ux,ug,ux,ux,ub,ub,ug,ug,ug,ug,ux,ux,ur,ur,ur,ur
ux,ux,ux,ux,ux,ux,ux,ux,ug,ux,ux,ub,ub,ub,ub,ug,ux,ux,ux,cr,ur,ur,cb
cg,ux,ux,ux,ux,ux,ux,ux,ux,ux,ux,ur,ub,ub,ub,ub,ub,ub,ur,ur,ur,ur,ur
cb,ux,ux,ux,ux,ux,ux,ux,ux,ux,ux,ur,ub,ub,ub,ub,ub,ub,ux,ur,ur,ur,ur
ux,ux,ux,ux,ux,ux,ux,ur,ur,ur,ur,ur,cg,ub,ub,ub,ux,ux,ux,ur,ur,cr,ur
ux,ux,ux,ux,ux,ux,cr,ux,cr,ux,ux,cg,cb,ub,ub,ub,cr,ux,ux,cr,ur,cr,cb