ur,ur,cr,ur,ur,ur,ur,cb,cb,cb,cg,cg,cg,cb,ur,ur,ur,ur,ur,cg,cb,cb,cb
ur,ur,ur,ur,ur,ur,ur,cg,ur,ur,ur,ur,ur,ur,ur,ur,cr,ug,ug,ug,ux,ur,ur
ur,cr,ur,ur,ur,ur,ur,ur,ur,ux,ur,ur,ur,ur,ur,ur,ur,ur,ur,ur,ur,ur,ur
cb,ur,ur,cr,ur,ur,ur,ur,cr,ux,ur,ur,ur,ur,ur,ur,ur,ur,ur,ur,ur,ur,ur
ux,ur,ux,ux,ur,ur,ux,ux,ux,ux,ur,ur,ur,ur,ur,ur,ur,ur,ur,ur,ur,ur,ur
ug,ug,ug,ug,ug,ug,ug,ur,ur,ur,ur,ur,ur,ur,ur,ur,ur,ur,ur,ur,ur,ur,ur
ug,ur,ux,ux,ug,ug,ug,ug,ur,ur,ur,ur,ur,ur,ur,ur,ur,ur,ur,ur,ur,ux,ux
ug,ur,ur,ur,ur,cg,ug,ug,ur,ur,ur,ur,ur,ur,ub,cr,ur,ur,ug,ur,ur,ux,ux
ux,ux,ux,ux,ux,ux,ur,ur,ur,ur,ur,cr,ub,ur,ub,ur,ur,ur,ur,ur,ur,ux,ux
ux,ux,ux,ux,ug,cr,ug,ug,ur,ur,ur,ur,ub,ur,ur,ur,ur,ur,ur,cr,ux,ux,ux
ur,ur,ur,ur,ug,ur,ug,ur,ur,ur,ub,ub,ur,ur,ur,ub,ur,ur,ub,ur,ux,ux,ux
ug,ug,ug,ug,ug,ur,ug,ug,cb,ub,ub,ub,ug,ug,ug,ug,ug,cb,ub,ub,ur,ur,ur
ug,ug,ux,ux,ug,ur,ur,ux,ub,ub,ux,ux,ur,ug,ug,ug,ub,cg,ub,ub,ur,ux,ur
ur,ug,ux,ug,ug,ur,ug,ug,ub,ub,cb,ug,ur,ug,ug,ux,ub,ub,ub,ub,ur,ub,ur
ur,ug,ux,ux,ug,ur,ur,ur,ur,ug,ug,ug,ug,ug,ur,ug,ug,ub,ub,ub,ur,ub,ur
ur,cg,ux,ux,ug,ur,ur,ur,ur,ub,ub,ub,ug,ub,ur,ux,ux,ux,ub,ub,ur,ub,ur
ur,ur,ux,ux,ux,ur,ur,ur,ur,ur,ux,ux,ur,ux,ur,ur,ur,ur,ur,ur,ur,ux,ur
ur,ur,ur,ur,ur,ur,ur,ur,ur,ur,ux,ux,ur,ur,ur,ur,ur,ur,ur,ur,ur,ur,ur
ur,ur,ur,ur,ur,ur,ur,ur,ux,ur,ux,ux,ux,ux,ux,ux,ux,ux,ux,ux,ux,ux,cb
cg,ux,ux,ux,ux,ux,ur,ur,ux,ur,ux,ux,ux,ux,ux,ux,ux,ux,ux,ux,ux,ux,ux
cb,ux,ux,ux,ux,ux,ur,ur,ux,ur,ur,ur,ur,ur,ur,ur,ur,ur,ur,ur,ur,ur,ur
ux,ux,ux,ux,ux,ux,ur,ur,ux,ux,ux,ux,cg,ux,ux,ux,cb,ux,ux,ux,ux,cr,cb
cb,ux,ux,ux,ux,ux,cr,cb,cr,ux,ux,cg,cb,ux,ux,ux,cr,ux,ux,cr,ux,cr,cb