ur,ur,cr,ur,ur,ur,ur,cb,cb,cb,cg,cg,cg,ur,ur,ur,cr,ux,ux,ux,cb,cb,cb
ur,ur,ur,ur,ur,ur,ur,cg,ub,ub,ub,ub,ub,ub,cb,ug,ug,ug,ug,ug,ug,ug,ux
ur,cr,ug,ug,ug,cr,ur,ur,ub,ur,ur,ug,ug,ug,ug,ur,ux,ux,ux,ux,ux,ug,ux
ur,ur,cg,ur,ur,ur,ur,ub,cb,ub,ub,cr,ug,ug,ug,ur,ux,ux,ux,ux,ux,ug,ux
ur,ur,ur,cr,ur,ur,ur,ur,ur,ur,cr,ur,ub,ub,ur,ur,ux,ux,ux,ux,ux,ug,ux
ur,ur,ur,ub,ur,ur,ur,ur,ub,ur,ur,ur,ug,ug,ug,ug,ug,ux,ux,ux,ux,ug,ux
ur,ur,ur,ub,ur,ur,ur,ur,ur,ur,ur,ur,ub,ub,ub,ur,ug,cg,ux,ux,ux,ug,ux
ur,ur,ur,ub,ur,ur,ur,ur,ur,ub,ub,ub,ub,ub,ub,ur,ur,ux,ux,ux,ux,ug,ux
ur,ur,ur,cb,ur,ur,ur,cr,ur,ub,ub,ub,ur,ub,ub,ur,ur,ux,ux,ux,ux,ug,ux
ur,ur,ur,ur,ur,ur,ub,ub,ub,ub,ub,ub,ur,ur,ur,ur,ur,ur,ug,ug,ug,ug,ux
ux,ur,ur,ur,ur,ur,ur,ur,ur,ur,ub,ub,ur,cr,ux,cb,ub,ug,ug,ur,ur,ux,ux
ux,ur,ur,ur,ur,ur,ub,ub,ub,ub,ub,ug,ug,ur,ug,ub,ub,ug,ug,ug,ux,ux,ux
ur,ur,ur,ur,ur,ub,ub,ub,ub,ub,ub,ub,ub,ur,cg,ug,ug,ug,ug,ux,ux,ux,ux
ur,ur,ur,ur,ur,ur,ur,ux,ux,ux,cb,ug,ur,ur,ur,ug,ug,ug,ug,ux,ux,ux,ux
ur,ur,ur,ur,ur,ug,ur,ux,ux,ux,ux,ug,ug,ur,ur,ug,ug,ur,ug,ux,ux,ux,ux
ur,ur,ur,ur,ur,ur,ur,ux,ux,ux,ux,ux,ur,ur,ur,ur,ux,ug,ug,ux,ux,ux,ux
ur,ur,ur,ur,ux,ug,ug,ug,ug,ug,ug,ug,ur,ur,ur,ur,ux,ug,ur,ux,ux,ux,ux
ux,ux,ux,ux,ux,ux,ux,ux,ux,ux,ux,ux,ug,cg,ur,ur,ub,ug,ur,ux,ux,ub,ub
ux,ux,ux,ux,ux,ux,ux,ux,ux,ux,ux,ux,ug,ur,ur,ur,ub,ug,ur,ub,cb,ub,cb
cg,ux,ux,ux,ux,ux,ux,ux,ux,ux,ux,ux,ug,ug,ug,ug,ug,ug,ur,ub,ub,ub,ub
cb,ux,ux,ux,ux,ux,ux,ux,ux,ux,ux,ux,ux,ux,ux,ux,ub,ub,ux,ux,ub,ub,ub
ux,ux,ux,ux,ux,ux,ux,ux,ux,ux,ux,ux,cg,ux,ux,ux,cb,ux,ux,ux,ux,cr,cb
cb,ux,ux,ux,ux,ux,cr,cb,cr,ux,ux,cg,cb,ux,ux,ux,cr,ux,ux,cr,ux,cr,cb