ur,ur,cr,cr,ur,ur,ur,cb,cb,cb,cg,cg,cg,ux,ux,ux,ux,ux,ux,ux,cb,cb,cb
ub,ub,ub,ur,ur,ur,ur,ur,ur,ux,cr,ur,ur,ux,ux,ux,ur,ur,ur,ux,ur,ur,ur
cb,cr,ur,ur,cr,ur,ur,cr,ur,ux,ux,ux,ur,ux,ux,ux,ur,ur,ur,ur,ur,ur,ur
cb,ur,ur,ur,ug,cg,ur,ux,ur,ur,ur,ur,ur,ux,ux,ub,ub,ub,ur,ur,ur,ur,ur
ur,cr,ur,ug,ug,ug,ur,ur,ur,ur,ur,ub,ur,ub,ub,ub,ub,ub,ur,ur,ur,ur,ur
ub,ub,ur,ug,ug,ug,ur,ur,ug,ug,ug,ug,ug,cg,ub,ub,ub,ub,ug,ug,ur,ur,ux
ub,ur,ur,ur,cg,ur,ur,ur,ug,ug,ug,ub,ub,ub,ub,ub,ub,ub,ug,ug,ur,ur,ux
ub,ur,ur,ur,ur,ux,ur,ur,ug,ug,ug,ur,cb,ub,ub,ub,ub,ub,ug,ug,ug,ug,ux
ub,ub,ub,ub,ur,ur,ux,ur,ux,ur,ug,ur,ub,ug,ug,ug,ug,ug,ug,ug,ur,cg,ux
cr,ux,ux,ub,ur,ur,ux,ur,ux,ux,ug,ub,ug,ug,ug,ug,ug,ug,ug,ug,ur,ur,ux
ur,ux,ux,ub,ur,ur,ur,ur,ur,ug,ug,ub,ur,ur,ug,cg,ug,ug,ug,ug,ur,ur,ux
ur,ux,ux,ub,ub,ub,ub,ub,ub,ug,ub,ug,ug,ug,ug,ug,ug,ug,ug,ug,ur,ur,ux
ur,ux,ux,ux,ux,ux,ux,ux,ux,ug,ug,ug,ug,ug,ug,ug,ug,ug,ug,ug,ug,ur,ux
ur,ux,ux,ux,ux,ux,ux,ux,ux,ux,ux,ug,ux,ux,ux,ug,ug,ug,ur,ug,ur,ur,ux
ur,ux,ux,ux,ux,ux,ux,ux,ux,ux,ux,ug,ux,ux,ux,ug,ug,ug,ur,ug,ug,ur,ux
ur,ux,ux,ux,ux,ux,ub,ub,ux,ux,ux,ug,ux,ub,ub,ug,ug,ub,ur,ur,ur,ur,ux
ur,ur,ur,ur,ur,ur,ur,ur,ur,ur,ur,ur,ur,ur,ur,ur,ur,ur,ur,ub,ur,ur,ux
ux,ux,ux,ux,ux,ux,ub,ub,ub,ub,ux,ug,ux,ub,ub,ub,ur,ur,ur,ur,ur,ur,ux
ux,ux,ux,ux,cb,ux,ub,cb,ub,ub,ub,ug,ug,ug,ug,ug,ug,ur,ub,ub,ur,ub,cb
cg,ub,ub,ub,ub,ur,ur,ub,ub,ur,ur,ur,ur,ur,ur,ur,ur,ur,ur,ur,ur,ub,ub
cb,ub,ub,ub,ub,ur,ur,ur,ur,cr,ux,ub,ub,ug,ug,ug,ug,ur,ub,ub,ur,ub,cb
ux,ur,ub,ux,ub,ur,ux,ub,ub,ub,ux,ub,cg,ub,ug,ug,ug,ug,ur,ur,ur,cr,cb
cb,ur,ur,ur,ur,ur,cr,ub,cr,ux,ux,cg,cb,ub,ub,ub,cr,ur,ur,cr,ur,cr,cb