ur,ur,cr,ug,ur,ur,ur,cb,cb,cb,ub,cg,cg,ur,ur,ur,ur,cb,ub,cr,cb,cb,cb
cg,ur,ug,ug,ur,cr,ug,ug,ug,ug,ug,ug,ug,ug,ug,ug,ug,ub,ug,ur,ug,ug,ug
ur,ur,ur,ug,ur,ug,ug,ug,ug,ug,ug,ug,ug,ug,ug,ug,ug,ub,ug,ur,ub,ub,ub
ur,ur,ur,ug,ur,ug,ug,ub,ug,ug,ug,ur,ur,ug,ur,ub,ub,ub,ub,ur,ub,ub,ub
ug,ur,ur,ub,ur,ub,ug,ub,ub,ub,ub,ur,ug,cb,ur,ur,ur,ur,ur,ur,ub,ub,ub
ug,ur,ur,ug,ur,ug,ug,ug,ug,ug,ug,ur,ub,ub,ub,ub,ub,ub,ub,ub,ub,ub,ub
cg,ur,ur,ur,ur,ur,ub,ur,ur,ur,cg,ug,ug,ug,ub,ub,ub,ub,ub,ur,ub,ub,ub
ub,ub,ub,ur,ur,ur,ub,ur,ub,ub,ub,ur,ug,ug,ub,ub,ub,ub,ug,ur,ub,ub,ub
ug,ug,cg,ub,ub,ur,ur,ur,ub,ub,ub,ur,ug,ug,ub,ub,ur,ur,ur,ur,ub,ub,ub
ug,ur,ug,ub,cb,ur,ub,ug,ug,ug,ug,ug,ug,ug,ur,ur,ub,ub,ub,ur,ub,ub,ub
ug,ur,ub,ub,ub,ub,cg,ug,ug,ug,ug,ug,ug,ug,ub,ur,ug,ug,ub,ur,ub,ub,ub
ug,ug,ug,ur,ug,ub,ug,ug,ug,ug,ur,ur,cr,ug,ub,ur,ub,ub,ub,ur,ub,ur,ub
ug,ug,ur,ur,ug,ur,ug,ug,ug,ur,ur,ug,ug,ug,ub,ur,ug,ug,ug,ur,ub,ub,ub
ug,ug,ub,ub,ug,ur,ug,ug,ug,ub,ur,ub,ub,ub,ub,ub,ug,ug,ub,ur,ur,ur,ub
cg,ub,ub,ub,ub,ub,ug,ug,ug,ug,ur,ub,ub,ub,ub,ub,ug,ug,ug,ur,ub,ub,ub
ug,ub,ub,ub,ub,ub,ug,ug,ug,ug,ur,ug,cb,ub,ub,ur,ug,ug,ug,ur,ub,ub,ub
ug,ub,ub,ub,ub,ub,ub,ug,ub,ur,ur,ug,ub,ub,ub,ub,ur,ub,ug,ur,ur,ur,ub
ug,ug,ub,cb,ub,ub,ub,ur,ub,ur,ur,ug,cb,ub,ub,ug,ug,ug,ug,ur,ur,ur,ub
ug,ug,ug,ub,ub,ub,ug,ub,cr,ur,ur,ur,ur,ub,ur,ug,ug,ug,ur,ur,ur,ur,ub
ug,ug,ug,ug,ug,ug,ug,ub,ur,ur,ub,ub,ub,ub,ub,ub,ub,ub,ub,ur,ub,ub,ub
cb,ug,ug,ug,ug,ug,ug,ub,ur,ur,ug,ub,ub,ub,ub,ub,ur,ug,ur,ur,ur,ur,ug
ug,ug,ug,ug,ug,ug,ug,ug,ur,ur,ug,ub,cg,ub,ub,ug,ur,ug,ur,ur,ur,cr,cb
cb,ug,ug,ug,ug,ug,cr,ug,ur,ur,ur,cg,cb,ub,ub,ub,ur,ur,ur,cr,ub,cr,cb