ur,ur,cr,ur,ur,ug,ug,cb,cb,cb,cg,ur,cg,ur,ur,ur,ur,ur,ur,cb,cb,ux,cb
ur,ur,ur,ur,cr,cg,cr,ux,ux,ux,ux,ur,ux,ur,ur,ur,ur,ur,ur,ur,ur,cb,cb
ur,ur,ug,cg,ur,ur,ur,ur,ur,ur,ur,ur,ux,ur,ur,ur,ur,ur,ur,ur,ur,ur,ur
cg,ur,cr,cr,ur,ur,ur,ur,ur,ur,ur,ur,ur,ur,ur,ur,ur,ur,ur,ur,ur,ur,ur
ur,ur,ug,ur,ur,ur,ur,ur,ur,ur,ur,ub,ur,ur,ur,ur,ur,ur,ur,ur,ur,ur,ur
ur,ur,ur,ur,ur,ur,ur,ur,ur,ur,ur,ur,ur,ur,ur,ur,ur,ur,ur,ur,ur,ur,ur
ur,ur,ur,ur,ur,ur,ur,ur,ur,ug,ug,ux,ux,cr,ur,ur,ur,ur,ur,ur,ub,ur,ux
ur,ur,ur,ur,ur,ur,ur,ur,ug,ub,ug,ug,ug,ug,ur,ur,ug,ur,ur,ur,ur,ur,ub
ur,ur,ur,ur,ur,ur,ur,ub,ub,ub,ux,ux,ux,ux,ux,ur,ug,ug,ug,ub,ub,ub,ub
ur,ur,ur,ur,ur,ur,ur,ub,ub,ub,ub,ux,ux,ux,ux,ur,ug,ug,ug,ub,ub,ub,ub
ur,ur,ux,ux,ur,ur,ur,ug,ub,ub,ub,cg,ub,ub,ur,ur,ub,ub,ub,ub,ub,ub,ub
ur,ur,ur,ur,ur,ur,ur,ub,ub,ub,ub,ug,ub,cb,ur,ur,ur,ur,ub,ur,ur,cr,ub
ur,ur,ur,ur,ur,ur,ur,ub,ub,ub,ub,cb,ur,ub,ub,ux,ug,ug,ub,ub,ub,ub,ub
ur,ur,ux,ux,ux,ux,ux,ub,ug,ug,ub,ub,ug,ug,ug,ur,ug,ub,cb,ub,ur,ur,cg
ux,ux,ux,ux,ux,ux,ux,ux,ug,ug,ug,ug,ug,ub,ug,ug,ug,ub,ub,ub,ub,ub,ub
ux,ux,ur,ur,ur,ur,ur,cg,ug,ur,ub,ub,ub,ub,ub,ux,ub,ux,ub,ub,ub,ub,ub
ur,ur,ur,ux,ux,ux,ux,ub,ub,ub,ub,ub,ub,ub,ub,ux,ub,ux,ub,ub,ub,ub,ub
ur,ur,ur,ur,ur,ur,cr,ux,ux,ug,ub,ub,ub,ub,ub,ub,ub,ux,ub,ub,ub,ur,ub
ux,ux,ux,ux,ux,ux,ux,ux,ub,ux,ux,ur,ux,cb,ux,ub,ub,ub,ub,ub,ub,ub,cb
cg,ux,ux,ux,ux,ux,ux,ux,ub,ux,ux,ur,ux,ug,ug,ub,ub,ub,ub,ub,ub,ub,ub
cb,ur,ur,ur,ur,ur,ur,ur,ur,ur,ur,ur,ur,ur,ur,ug,ug,ub,cb,ub,ub,ub,ub
ux,ur,ux,ux,ux,ur,ur,ur,ur,ur,ur,ur,cg,ux,ux,ux,ux,ux,ux,ux,ux,cr,ur
ux,ur,ur,ur,ur,ur,cr,ux,cr,ux,ux,cg,cb,ux,ux,ux,cr,ux,ux,cr,ux,cr,cb