ur,ur,cr,ur,ur,ux,ux,cb,cb,cb,cg,ur,cg,ur,ur,ur,ur,ur,ur,cb,cb,ux,cb
ur,ur,ur,ur,ur,ur,ur,ur,ur,ur,ur,ur,ur,ur,ur,ur,ur,ur,ur,ur,ur,cb,cb
ur,ur,ur,ur,cg,ur,ur,ur,ux,ux,ux,cr,ur,ur,ur,ur,ur,ub,cr,ur,ur,ux,ux
cg,ur,ur,cr,ug,ur,ur,ur,ur,ur,ur,ur,ur,ur,ur,ur,ux,cr,ub,ur,ur,ux,ux
ur,ur,ur,ur,ug,cr,ur,cg,ug,ur,ur,ub,ur,ur,ur,ur,ux,ur,ug,ub,ub,ub,ur
ur,ug,ug,ug,ug,ug,ug,ug,ug,ur,ur,ur,ur,ur,ur,ur,ux,cb,ug,ub,ub,ub,ub
ur,ur,ur,ur,ur,ur,ug,ug,ur,ug,ug,ux,ux,ux,ux,ur,ux,ub,ug,ub,ub,ub,ur
ur,ur,ur,ur,ur,ur,ub,ub,ur,ub,ug,ug,ug,ug,ug,ur,ug,ub,ug,ub,ub,ub,ub
ur,ur,ur,ur,ur,ur,ub,ub,ub,ug,ug,ug,ug,ug,ug,ur,ug,ub,ub,ub,ub,ub,ub
ur,ux,ur,cr,ur,ur,ux,ub,ub,ux,ug,ug,ug,ug,ug,ur,ug,ug,ux,ub,ub,ub,ub
ur,ux,ur,ur,ur,ur,ux,ux,ub,ub,ur,ur,ur,ur,ur,ur,ur,ur,ur,ur,ur,cb,ub
ur,ur,ur,ur,ur,ur,ux,ux,ub,ub,cb,ub,ub,ug,ug,ug,ug,ug,ux,ux,ux,ux,ur
ux,ub,ub,ub,ux,ux,ux,ux,ub,ub,ug,cg,ug,ug,ur,ur,ub,cb,ur,ur,ur,ur,ur
ub,ub,ub,ub,ux,ux,ux,ux,ub,ub,ub,ub,ug,ug,ur,ur,ub,ub,ur,ur,ur,ur,cg
ub,ub,ub,ub,ux,ux,ux,ux,ux,ub,ub,cb,ug,ug,ug,ux,ux,ub,ub,ub,ub,ub,ub
ub,ub,ub,ub,ub,ux,ux,ux,ub,ub,ub,ug,ug,ug,ux,ux,ux,ux,ub,ub,ub,ub,ub
ub,ub,ub,ub,ub,ux,ux,ub,ub,ub,ub,ug,ug,ur,ux,ux,ux,ux,ub,ub,ub,ub,ub
ub,ub,ub,ub,ub,ux,ux,ub,ub,ug,ug,ug,ug,ug,ux,ux,ux,ux,ux,ub,ub,ur,ub
ub,ub,ub,ub,ub,ux,ux,ub,ub,ub,ux,ux,ur,ug,ux,ux,ux,ux,ux,ub,ux,ur,cb
cg,ub,ub,ub,ub,ub,ub,ub,ub,ux,ux,ux,ur,ug,ug,ug,ur,ur,ur,ub,ub,ur,ur
cb,ux,ux,ux,ux,ux,ux,ux,ub,ub,ub,ub,cr,ur,ur,cg,ur,ur,ur,ur,ur,ur,ur
ux,ux,ux,ux,ux,ux,ux,ux,ux,ux,ux,ux,cg,ux,ux,ux,ux,ux,ux,ux,ux,cr,ur
ux,ux,ux,ux,ux,ux,cr,ux,cr,ux,ux,cg,cb,ux,ux,ux,cr,ux,ux,cr,ux,cr,cb