cr,ur,cr,ug,ug,ug,ur,cb,cb,cb,ub,cg,cg,ub,ug,ug,ug,ug,ug,ug,cb,cb,cb
ug,ur,ur,ug,ug,ug,ur,ug,ug,ub,ub,cb,ub,ug,ug,ug,ug,ug,ug,ug,ug,ub,cg
ug,ur,ur,ug,ug,ug,ur,ug,ug,ug,ub,ub,ub,ug,ug,ub,ug,ug,ug,ug,ug,ug,ug
ug,ur,ur,ug,ug,ug,ur,ug,ug,ug,ug,ub,ub,ug,ug,ug,ug,ur,ur,ur,ug,ug,ub
ur,ur,ur,ur,ur,ur,ur,ur,ub,ub,ug,ug,ug,ug,ug,ug,ug,ur,ug,ur,ug,ug,ur
ug,ur,ur,ug,ug,ug,ug,ug,ug,ug,ug,ug,ug,ug,ug,ug,ug,ur,ug,ur,cg,ub,ur
cg,ur,ur,ug,ug,ug,ur,ug,ub,ub,ur,ur,ur,ur,ur,ur,ur,ur,ug,ur,ug,ug,ur
ub,ur,ur,ur,ug,ug,ur,ub,ub,ub,ub,ur,ur,ug,ur,ug,ug,ug,ug,cr,ug,ug,ug
ub,ur,ur,ur,ug,ug,ur,ub,ub,ub,ug,ug,ug,ug,ur,ur,ur,ug,ur,ur,ug,ug,ur
ub,ur,ur,ur,ug,ug,ur,ub,ub,ub,ug,ug,ug,ug,ur,ug,ub,ug,ug,ur,ug,ug,ur
ub,ur,ur,ur,ug,ur,ub,cb,ug,ug,ug,ur,ur,ug,ur,ug,ub,ug,ub,ug,ug,ug,ur
ub,ur,ur,ug,ug,ur,ub,ub,ug,ur,ug,ur,ug,ug,ur,ug,ub,ug,ub,ug,ug,ug,ur
ub,ur,ur,ur,ur,ur,ub,ur,ug,ur,ug,ur,ug,ug,ur,ug,ug,ug,ur,ur,ur,cg,ur
ub,ur,ur,ur,ug,ur,ur,ug,cg,ug,ug,ur,ur,ur,ur,ur,ur,ug,ur,ub,ub,ur,ur
ub,cg,ur,ur,ug,ur,ur,ub,ug,ur,ug,ur,ur,ug,ur,ug,ug,ug,ur,ub,ub,ub,ur
ug,ug,ur,ur,ub,ur,ur,ub,ug,ub,ug,ug,ur,ug,ur,ug,ug,ug,ur,ub,ub,ub,cb
ug,ug,ur,ur,ur,ur,ur,ur,ug,ur,ub,cb,ur,ur,ur,ur,ur,ug,ur,ub,ur,ur,ub
ug,ug,ug,ug,ug,ug,ur,ur,ug,ug,ug,ub,ur,ur,ur,ur,ur,ur,ur,ub,cb,ub,ub
ug,ug,ug,ug,ug,ur,ur,ug,ug,ug,ub,ub,ur,ur,ug,ug,ub,ub,ub,cb,ub,ub,ub
ub,ub,ub,ub,ub,ub,ub,ub,ug,ub,ub,ub,ur,ur,ug,ug,ur,ub,ub,ub,ub,ub,cr
cb,ur,ug,ug,ug,ug,ur,ur,ug,ub,ur,ub,ur,ur,ur,ur,ur,ur,ub,ur,ur,ur,ur
ur,ur,ur,ug,ur,ug,ur,ur,ug,ub,ub,ub,cg,ur,ur,ur,ur,ur,ur,ur,ur,cr,cb
cb,ug,ug,ug,ug,ug,cr,ug,ug,ug,ur,cg,cb,ur,ur,ur,ur,cb,ug,cr,ur,cr,cb