ug,cr,cr,ug,ug,ug,ur,cb,cb,cb,ub,cg,cg,ur,ur,ur,ur,ur,ur,ur,cb,cb,cb
ug,ug,ug,ug,ug,ug,ug,ug,ug,ug,ug,ug,ug,ug,ug,ug,ug,cb,ub,ub,ub,ub,ug
ug,ug,ur,ub,ub,ub,ub,ub,ub,ub,ub,ur,ur,ur,ur,ub,ub,ub,ug,ub,ub,ub,ug
ub,ub,cb,ug,ug,ug,ug,ug,ug,ug,ug,cg,ub,ur,ur,ub,ub,ub,ug,ub,ub,ub,ug
ub,ub,ub,ub,ub,ub,ug,ub,ug,ub,cb,ug,ug,ur,ur,ug,ug,ug,ug,ub,ug,ur,ug
ub,ub,ub,ub,ub,ub,ub,ub,ub,ub,ub,ub,ub,ur,ur,ub,ub,ub,ub,ub,ub,ur,ug
cg,ub,ur,ub,ub,ub,ub,ub,ub,ub,ub,ub,ub,ur,ur,ur,ur,ur,ur,ub,ub,ur,ug
ub,ug,ur,ur,ug,ub,ub,ub,ub,ub,ub,ub,ub,ur,cb,ub,ub,ub,ub,ub,ub,ur,ug
ug,ug,ug,ug,ug,ub,ur,ub,ub,cb,ub,ub,ug,ur,ur,ur,ur,ur,ur,ub,ub,ur,ur
ug,ug,ur,ug,ug,ub,ub,ub,ub,ub,ub,ub,ub,ub,ub,ub,ub,cg,ug,ub,ub,ub,ur
ug,ug,ur,ug,ug,ub,ub,ub,ur,ub,cr,ub,ur,ug,ug,ug,ug,ug,ug,ur,ub,ub,ur
ug,ug,ug,ug,ug,ub,ub,ub,ub,ub,ur,ub,ub,ug,ur,ur,ub,ub,ub,ur,ub,ur,ur
ug,ug,ur,ug,ug,ur,ub,ub,ub,ub,ur,ur,ur,ur,ur,ub,ub,ug,ub,ur,ub,ub,ub
ug,ug,ug,ug,ug,ur,ub,ub,ub,ub,ub,ub,ub,ug,ug,ug,ug,ug,ub,ub,ur,ur,ub
ug,cg,ug,ug,ug,ug,ug,ug,ug,ug,ug,ug,ug,ug,ug,ug,ug,ug,ug,ub,ub,ub,ub
ug,ug,ur,ur,ug,ug,ug,ub,ug,ug,ur,ur,ur,ub,ub,ug,ug,ug,ub,ub,ur,ur,ur
ug,ug,ug,ug,ug,ub,ug,ug,ug,ur,ub,ub,ub,ub,ub,ur,ur,ub,ur,cb,ur,ur,ur
ug,ug,ur,ug,ug,ub,ug,ur,ub,ub,ub,ub,ub,ub,ug,ur,ur,ur,ur,ur,ur,ur,ur
ug,ug,ur,ug,ub,ub,ub,ub,ub,ub,ub,ub,ub,ub,ub,ur,ug,ug,ug,ug,ur,ur,ur
ug,ug,ur,ug,ur,ur,ub,ub,ub,ub,ub,ub,ub,ur,ur,ur,ur,ur,ur,ur,ur,ur,ur
cb,ug,ug,ug,ug,ub,ub,ug,ug,ug,ug,ub,ub,ub,ub,ub,ur,ug,ug,ur,cr,ur,cg
cg,ug,ug,ug,ug,ug,cb,ug,ug,ug,ug,ub,cg,ub,ub,ug,ur,ug,ug,ug,ub,cr,cb
cb,ug,ug,ug,ug,ug,cr,ug,ug,ug,ur,cg,cb,ub,ub,ub,ur,ur,cr,cr,ub,cr,cb