cr,ur,cr,ub,cb,ur,ur,cb,cb,cb,cg,cg,cg,ur,ur,ur,ur,ur,ur,ur,cb,cb,cb
cg,ur,cr,ur,ur,ur,ur,ux,ux,ux,ux,ux,ux,ur,ur,ur,ur,ur,ur,ur,ur,ur,ur
ur,cr,ux,ux,ux,ur,ur,ux,ux,ux,ur,ur,ur,ur,ux,ur,ux,ux,ur,ur,ur,ur,ur
ur,ux,ub,ur,ur,ur,ur,ur,ur,ur,ur,ub,ub,cr,ux,ur,ur,ur,ur,ur,ur,ur,ur
ur,ur,ub,ur,ur,ur,ur,ur,ur,ur,ur,ub,cb,ur,ux,ux,ub,ub,ub,ur,ub,ub,ur
ux,cr,cb,ur,ur,ur,ur,ur,ur,ur,ur,ux,ub,ub,ub,ub,ub,ux,ux,cr,ux,ub,ux
ux,ur,ur,ur,ur,ur,ur,ur,ur,ur,ur,ux,ux,ux,ux,ub,ub,ux,ux,ux,ux,ub,ux
cr,ur,ur,ur,ur,ur,ur,ur,ur,ur,ux,ux,ux,ux,ux,ux,ux,ux,ux,ux,ux,ub,ux
ur,ur,ub,ub,ub,ub,ub,ub,ux,ux,ux,ux,ux,ug,ug,ug,ug,ug,ug,ug,ub,ub,ux
ur,ux,ux,ug,ug,ug,ug,ug,ux,ux,ux,ux,ux,ug,ug,ug,ug,ug,ug,ug,cg,ux,ux
ur,ux,ux,ug,ux,ux,ux,ug,ux,ux,ux,ux,ux,ub,cg,ug,ug,ug,ug,ug,ub,ux,ux
ur,ux,ux,ug,ug,ug,ug,ug,ux,ub,ub,ub,ub,ub,ug,ug,ug,ug,ux,ug,ub,ux,ux
ur,ux,ux,ug,ug,ug,ug,ug,ug,ug,cg,ub,ub,ub,ug,ug,ug,ug,ug,ug,ux,ux,ux
ur,ux,ux,ug,ux,ux,ub,ub,ub,ub,cb,ux,ux,ug,ug,ux,ux,ux,ux,ux,ux,ux,ux
ur,ux,ux,ug,ux,cb,ub,ub,ub,ub,ub,ub,ub,ug,ug,ug,ug,ux,ug,ug,ux,ux,ux
ur,ux,ug,ug,ux,ux,ux,ux,ux,ux,ub,ug,ub,ub,ub,ub,ub,ub,cb,ug,ux,ux,ux
ur,ug,ug,ug,ug,ux,ux,ux,ux,ub,ub,ug,ub,ub,ux,ux,ux,ug,ug,ug,ux,ux,ux
ur,ur,ur,ur,ur,ur,ur,ur,ur,ur,ur,cr,ux,ux,ug,ug,ux,ug,ug,ug,ux,ux,ux
ux,ux,ux,ux,ux,ux,ux,ux,ux,ub,ux,cg,ug,ug,ug,ug,ux,ux,ux,ug,ux,ux,cb
cg,ux,ux,ux,ur,ur,ur,ur,ur,ur,ur,ur,ur,ur,ur,ug,ug,ug,ug,ug,ur,ur,ur
cb,ux,ux,ux,ur,cr,ux,ux,ux,ub,ub,ub,ux,ux,ux,ux,ux,ur,ur,ur,ur,ur,ur
ux,ux,ux,ux,ur,ur,ux,ux,ux,ub,ux,ux,cg,ux,ux,ux,ux,ux,ux,ux,ux,cr,cb
cb,ux,ux,ux,ur,ur,cr,cb,cr,ub,ub,cg,cb,ux,ux,ux,ux,ux,ux,cr,ux,cr,cb