ux,ur,cr,ur,ur,ur,ur,cb,cb,cb,cg,ur,cg,ur,ur,ur,ur,ur,ur,cb,cb,ux,cb
ux,ur,ub,ug,cr,ur,ur,ur,ur,ur,ur,ur,ur,ur,ur,ur,ur,ur,ur,ur,ur,cb,cb
ur,ur,cr,cg,cb,ur,cr,ur,ur,ur,ur,ur,ur,ur,ur,ur,ur,ur,ur,ur,ur,ur,ur
cg,ur,ur,ub,ur,ur,ur,ur,ur,ur,ur,ur,ur,ur,ur,ur,ur,ur,ur,ur,ur,ur,ur
ur,ur,ug,ur,ur,ur,ur,ur,ur,cr,ur,ur,ur,ur,ur,ur,ur,ur,ur,ur,ur,ux,ux
ug,ug,ug,cg,ur,ur,ur,ub,ug,cg,ur,ur,ur,ur,ur,ub,ug,ux,ux,ux,ux,ux,ux
ug,ur,ug,ug,ug,ug,ub,cb,ug,ug,ur,ub,ub,ub,ub,ub,ub,ur,ub,ub,ub,ub,ub
ug,ug,ug,ug,ug,ug,ub,ur,ur,ur,ur,ub,ub,ub,ug,ug,ub,ub,ub,cb,ub,ux,ub
ub,ub,ub,ub,ub,ub,ub,ur,ur,ur,ub,ub,ub,ub,ur,ub,ub,ur,ub,ub,ub,ub,ub
ub,ub,ur,ux,ub,ub,ub,ur,cr,ur,ub,ur,ur,ub,ur,ub,ub,ur,ub,ux,ub,ub,ux
ub,ux,ur,ux,ub,ux,ux,ur,ub,ub,ub,ur,ur,ur,ur,ux,ub,ur,ub,ub,ub,ub,ub
ux,ux,ur,ub,ub,ux,ux,ur,ub,ux,ug,ug,ug,ug,ug,ug,ub,ur,ub,ub,ub,ub,ub
ux,ux,ur,ub,ux,ux,ug,ur,ux,ug,ug,ub,ub,ub,ub,ug,ub,cg,ur,ur,ub,ub,ub
ux,ux,ur,ub,ux,ux,ux,ur,ug,ug,ux,cb,ub,ub,ub,ug,ug,ug,ur,ur,ub,ub,cg
ux,ux,ur,ub,ux,ur,ur,ur,ug,ug,ug,ub,ur,ub,ub,ub,ur,ur,ur,ur,ux,ub,ub
ux,ux,ur,ub,ux,ur,ux,ub,ub,ub,ux,ur,ug,ug,ux,ux,ux,ub,ur,ur,ub,ub,ub
ux,ux,ur,ub,ux,ur,ux,ux,ux,ub,ub,ub,ub,ub,ub,ux,ux,ub,ur,ur,ux,ux,ur
ux,ux,ur,ub,ux,cr,ux,ux,ux,ux,ux,ur,ux,ux,ub,ux,ux,ub,ur,ur,ux,ux,ur
ux,ux,ur,ub,ux,ux,ur,ur,ur,ur,ur,ur,ux,ux,ub,ux,ux,ub,ur,ur,ur,ur,ur
cg,ux,ur,ub,ux,ur,ur,ur,ur,ur,ur,ur,ur,ur,cb,ur,ur,ur,ur,ur,ux,ux,ux
cb,ux,ur,ux,ux,ur,ur,ux,ux,ux,ux,cr,ux,ux,ux,ux,ux,ur,ur,ur,ux,ux,ux
ux,ux,ur,ur,ur,ur,ur,ur,ur,ur,ur,ur,cg,ux,ux,ux,ux,ux,ux,ux,ux,cr,ux
ux,ux,ux,ux,ux,ux,cr,ux,cr,ux,ux,cg,cb,ux,ux,ux,cr,ux,ux,cr,ux,cr,cb