ur,ur,cr,ur,ur,ur,ur,cb,cb,cb,cg,ur,cg,ur,ur,ur,ur,ur,ub,cb,cb,ur,cb
ur,ur,ur,ur,ur,cr,ur,ub,ur,ur,ur,ur,ur,ur,ur,ur,ur,ur,ub,ub,ur,ur,ur
ur,ur,ur,cr,cr,ur,ur,ub,ur,ur,ur,ur,ur,ur,ur,ur,ur,ur,ub,ub,ub,ub,ur
ur,ur,ur,ug,ug,cb,ur,ub,ub,ur,ur,ur,ur,ur,ur,cb,ub,ub,ub,ub,ub,cb,ur
ur,ug,ug,ug,cg,ub,ub,cb,ub,ur,ur,ur,ur,ur,ur,ur,ur,ub,ub,ub,ub,ub,ur
ur,ug,ug,ug,ug,ug,ug,cr,ur,ur,ur,ur,ur,ur,ub,ub,ub,ub,ub,ub,ub,ux,ur
ur,ur,ug,ug,ug,ug,ug,ur,ur,ur,ur,ur,ug,ux,ub,ux,ub,ub,ub,ub,ub,ub,ur
ug,ug,ux,ug,ug,ug,cg,ur,ug,cr,ur,ug,ug,ug,ug,ug,ug,ug,ub,cr,ur,ur,ur
ux,ur,ur,ur,ur,ub,ub,ub,ub,ug,ug,ug,ub,ub,ub,ub,ub,ug,ug,cr,ur,ur,ur
ux,ur,ux,ur,ur,ux,ux,ux,ub,ug,ug,ug,ub,ug,ub,ub,ug,ub,ug,ub,ub,ub,ur
ux,ur,ux,ur,ur,ux,ux,ux,ux,ux,ux,ug,ub,ug,ug,ub,ub,ub,ug,ug,ub,ub,ur
cg,ur,ux,ur,ur,ur,ur,ur,ur,ur,ug,ug,ug,ug,ug,ur,ur,ub,ur,ug,cg,ur,ur
ux,ur,ux,ur,ug,ug,ug,ug,ug,cg,ug,ux,ub,ub,ub,ub,ub,ub,ub,ub,ub,ub,ub
ux,ur,ux,ur,ug,ux,ug,ug,ug,ug,ug,ub,ub,ug,ug,ug,ub,cb,ub,ub,ub,ub,ub
ux,ur,ux,ur,ug,ug,ug,ur,ur,ub,ub,ub,ub,ur,ug,ug,ub,ub,ug,ub,ub,ub,ub
ux,ur,ur,ur,ur,ux,ux,ux,ub,ub,ub,ub,ub,ur,ur,ub,ub,ug,ug,ub,ub,ub,ub
ux,ux,ux,ux,ux,ux,ux,ux,ub,ub,ux,ux,ub,ub,ub,ub,ub,ux,ux,ux,ur,ur,ux
ux,ux,ux,ux,ux,ux,ux,ux,ux,ux,ux,ux,ux,ur,ux,ur,ub,ux,ux,ux,ur,ur,ux
ux,ux,ux,ux,ux,ux,ux,ux,ux,ux,ux,ux,ux,ur,ux,ur,cb,ux,ux,ux,ur,ur,cb
cg,ux,ux,ux,ux,ux,ux,ux,ux,ux,ux,ux,ux,ur,ux,ur,ur,ur,ur,ur,ur,ur,ur
cb,ux,ux,ux,ux,ux,ux,ux,ux,ux,ux,ux,ux,ur,ux,ur,ur,ux,ux,ux,ur,ur,ur
ux,ux,ux,ux,ux,ux,ux,ux,ux,ux,ux,ux,cg,ur,ux,ur,ur,ur,ur,ur,ur,cr,ur
ux,ux,ux,ux,ux,ux,cr,ux,cr,ux,cb,cg,cb,ur,ur,ur,cr,ux,ux,cr,ur,cr,cb