ur,ur,cr,ur,ux,ur,ur,cb,cb,cb,cg,ux,cg,ur,ur,ur,cr,ux,ux,cb,cb,ux,cb
ur,ur,ur,ur,ur,ur,ur,ur,ur,ur,ur,ur,ur,ur,ur,cr,ub,ub,ux,ux,ux,cb,cb
ur,ur,ur,cr,ur,ur,ur,ur,ur,ur,ur,ur,ur,ur,ur,ub,ux,ub,ux,ux,ur,ur,ur
cg,ur,ur,ug,ur,ug,ur,ur,ur,ur,ur,ur,ur,ur,ur,ub,ub,ub,ux,ux,ur,ur,ux
ur,ur,ug,ug,ug,cg,ur,ur,ur,ur,ur,ur,ur,ur,ur,ub,ub,ux,ux,ux,ux,ur,ux
cg,ug,ug,ug,ug,ur,cr,ur,cg,ug,ug,ur,ur,ur,ub,ub,ub,ux,ux,ux,ux,ur,ux
ur,ur,ug,ug,ug,ug,ug,ug,ur,ur,ug,ur,ug,ug,ub,ub,cb,ur,ux,ur,ur,ur,ur
ur,ur,cr,ur,ur,ur,ur,ur,ur,ur,ug,ur,ur,ug,ub,ub,ub,ur,ur,ur,ur,ur,ur
ux,ux,ux,ux,ux,ux,ux,ur,ur,ur,ur,cr,ug,ug,ub,ub,ub,ur,ur,ur,ur,ur,ur
ub,ub,ub,ux,ux,ux,ux,ur,ur,ur,ur,ug,ug,cb,ub,ub,ub,ur,ur,ur,ub,ux,ux
ub,ux,ub,ux,ux,ux,ux,ux,ub,ur,ur,ug,ug,ub,ub,ub,ur,ur,ur,ub,ub,ux,ux
ub,ux,ub,ub,cb,ux,ux,ug,ux,ub,ug,ug,ug,ub,ub,ub,ub,ur,ur,ur,ur,ur,ur
ub,ux,ub,ub,ux,ux,ux,ub,ub,ub,ub,ub,ug,ug,ub,ub,ub,ug,ub,ur,ur,ur,ur
ub,ux,ub,ub,ux,ux,ux,ub,ub,ub,ub,ug,ug,ug,cg,cb,ub,ux,ub,ub,ur,ur,cg
ub,ux,ub,ub,ux,ux,ub,ub,ub,ub,ug,ug,ub,ux,ug,ug,ub,ux,ux,ux,ur,ur,ub
ub,ux,ub,ub,ub,ub,ub,ug,ug,ur,ux,ub,ub,ub,ux,ux,ur,ux,ux,ux,ur,ur,cb
ub,ur,ub,ub,ub,ux,ux,ux,ux,ux,ub,ub,ub,ub,ux,ux,ur,ux,ux,ux,ur,ur,ur
ub,ur,ub,ub,ub,ub,ub,ub,ub,ub,ub,ub,ub,ub,ux,ux,ur,ux,ux,ux,ur,ur,ur
ub,ub,ub,ub,ub,ub,ub,ux,ux,ux,ux,ub,ub,ub,ub,ub,ur,ur,ur,ur,ur,ur,ur
cg,ub,ub,ub,ub,ux,ub,ub,ub,ub,ub,ub,ub,ub,ub,ub,ur,ur,ub,cr,ur,ur,ur
cb,ub,ux,ux,ub,ux,ux,ux,ux,ux,ux,ub,ub,ub,ub,ub,ur,ur,ur,ur,ur,ur,ur
ub,ub,ux,ux,ub,ux,ux,ux,ux,ux,ux,ux,cg,ub,ub,ub,ur,ur,ur,ur,ur,cr,ur
ub,ub,ub,ub,ub,ux,cr,ux,cr,ux,ux,cg,cb,ub,ub,ux,cr,ux,ux,cr,ur,cr,cb