cr,ub,cr,ux,ub,ub,cb,cb,cb,cb,ux,cg,cg,ug,ug,ug,ug,ug,ug,ug,cb,cb,cb
cr,cr,cr,ur,ur,ur,ur,ur,ur,ur,ur,ur,ur,ug,ur,ur,ur,ur,ur,ug,ux,ux,ux
cb,cr,ur,ur,ux,ux,ux,ux,ux,ux,ux,ux,ux,ug,ur,ur,ur,ur,ur,ug,ux,ux,ux
ub,cr,ub,ur,ux,ux,ux,ux,ux,ux,ux,ux,ux,ug,ur,ux,ux,ux,ux,ug,ux,ux,ux
ub,ub,ub,ux,ux,ux,ux,ux,ux,ux,ux,ux,ux,ug,ur,ux,ux,ux,ux,ug,ux,ux,ux
ur,ux,ur,ux,ux,ux,ux,ux,ux,ux,ux,ur,ur,ur,ur,ux,ux,ux,ux,ug,ux,ux,ux
ur,ux,ur,ux,ux,ux,ux,ux,cg,ug,ug,ur,ux,ur,ur,ux,ux,ux,ux,ug,ux,ux,ux
ur,ux,ur,ux,ug,ug,ug,ug,ug,ug,ug,ur,ux,ur,ur,ux,ux,ux,ux,ux,ux,ux,ux
ur,ux,ur,ux,ug,ux,cb,ub,ub,ub,ub,ub,ux,ur,ur,ux,ux,ux,ux,ux,ux,ux,ux
ug,ug,ug,ug,ug,ug,ug,ub,ub,ub,ub,ub,ub,ur,ur,ub,ux,ux,ux,ux,ux,ux,ux
ug,ur,ug,ug,ug,ux,ug,ub,ub,ub,ub,ub,ub,ur,ur,ub,ux,ux,ux,ux,ux,ux,ux
ug,ux,ug,ux,ux,ug,ug,ux,ux,ux,ux,ur,ub,ur,ur,ub,ux,ux,ux,ux,ux,ux,ux
ug,ub,ug,ux,ux,ux,ux,ux,ux,ux,ux,ur,ug,cr,ur,ux,ux,ux,ux,ux,ux,ux,ux
ug,ub,ug,ug,ug,ug,ug,ug,ug,ug,ug,ur,ux,ug,ur,ux,ux,ux,ux,ux,ux,ux,cr
ug,ub,ub,ub,ux,ug,ug,ug,ux,cg,ug,ug,ug,ug,ur,ur,ur,ur,ur,ur,ur,ur,ur
ub,ub,ub,ub,ux,ug,ug,ug,ug,ug,ug,ug,ug,ug,ug,ug,ug,ub,ux,ux,ux,ux,ux
ub,ub,ub,ub,ug,ug,ur,ur,ur,ur,ur,ur,ur,ur,ur,ur,ur,ur,ur,cg,ur,ur,cr
ux,ub,cb,cb,ux,ug,ug,ug,ug,ug,ub,ub,ub,ub,ub,ux,ug,ug,ug,ug,ux,ux,cg
ux,ux,ux,ub,ux,ub,ub,ux,ug,ux,ub,ub,ux,ub,ub,ub,ug,ug,ux,ux,ux,ux,cb
cg,ux,ug,ub,ub,ub,ub,ub,ug,ux,ux,ub,ux,ux,ux,ux,ux,ux,ux,ux,ux,ux,ux
cb,ux,ug,ug,ug,cb,ub,ub,ug,cg,ug,ug,ug,ux,ux,ux,ux,ux,ux,ux,ux,ux,ux
ux,ux,ux,ux,ux,ub,ur,cg,ug,ub,ug,ub,cg,ux,ub,ub,cb,ub,ub,ux,ux,cr,cb
cb,ux,ux,ux,ux,ub,cr,cb,cr,ug,ug,cg,cb,ux,ub,ub,ub,ub,ub,cr,ux,cr,cb