ux,ux,cr,ur,ur,ur,ur,cb,cb,cb,cg,cg,cg,ur,ur,ur,ur,ur,ur,ur,cb,cb,cb
ur,ur,ur,ur,cb,ur,cr,ur,ur,ur,ur,ur,ur,ur,ur,ur,ur,ur,ur,ur,ur,ur,ur
ur,cr,ub,ub,ub,ug,ur,ur,ur,ur,ur,ur,ur,ur,ur,ur,cb,ub,ub,ub,ur,ur,ur
cb,ur,ub,cg,ug,ug,ur,ur,ur,ur,ur,ug,ug,ub,ub,ub,ub,ub,ub,ub,ur,ur,ur
ur,ur,cr,cr,ur,cr,ur,ur,ur,ur,ur,ug,ug,ub,ub,ur,ur,ub,ub,ub,ux,ux,ur
ur,ur,ur,ur,ur,ur,ur,cr,ur,ug,ur,ug,ug,ub,ub,ur,ur,ub,ub,ub,ur,ux,ur
ur,cg,ug,ug,ug,ug,ug,ur,ug,ug,ug,ug,ub,ub,ub,ub,ub,ub,ub,ub,ur,ux,ur
ub,ug,ug,ug,ug,ug,ug,ug,ug,ug,ug,ug,ug,cg,ub,ub,ux,ub,ub,ub,ur,ux,ur
ub,ub,ug,ug,ur,ug,ug,ux,ux,ug,ur,ux,ug,ug,cb,ub,ub,ub,ux,cb,ub,ub,ur
ub,ub,ux,ux,ug,ug,ux,ux,ux,ug,ur,ub,ub,ub,ub,ub,ub,ux,ux,ub,ur,ub,ur
ub,ub,ub,ux,ug,ug,ug,ug,ug,ug,ur,ug,ug,ub,ub,ub,ub,ub,ux,ub,ux,ub,ux
ub,ub,ug,ug,ug,ug,ug,ug,ub,ub,ur,ub,ux,cg,ug,ug,ug,ug,ub,ub,ub,ub,ux
ub,ub,ub,ub,ub,cg,ub,ub,ub,ub,ur,ub,ub,ug,ub,ug,ug,ug,ug,ug,cr,ux,ux
ub,ub,ub,ux,ux,ur,ug,ug,ug,ub,ur,ug,ug,ug,ug,ug,ug,ug,ug,ug,ur,ux,ux
ub,ub,ub,ub,ub,ur,ug,ug,ug,ub,ur,ub,ub,ur,ug,ug,ux,ub,ub,ur,ur,ux,ux
ub,ub,ub,ub,ub,ur,ux,ux,ux,ub,ur,ub,ub,ub,ub,ub,ub,ub,ux,ur,ur,ux,ux
ub,ub,cr,ub,ub,ur,ux,ux,ux,ur,ur,ub,ub,ub,ub,ub,ub,ub,ub,ur,ur,ux,ux
ux,ux,ur,ux,ux,ur,ux,ux,ux,ur,ur,ux,ub,ub,ub,ub,ub,ub,ub,ur,ur,ux,ux
ux,ux,ur,ub,ub,ur,ux,ux,ux,ur,ur,ux,ub,ub,ub,ub,ub,ub,ub,ur,ur,ux,cb
cg,ux,ur,ux,ux,ur,ux,ux,ux,ur,ur,ub,ub,ub,ub,ub,ub,ub,ub,ur,ur,ub,ub
cb,ux,ur,ux,ux,ur,ux,cb,ux,ur,ur,ub,ub,ub,ub,ub,ub,ub,ub,ur,ur,ub,ub
ux,ux,ur,ux,ux,ur,ux,ub,ub,ub,ub,ub,cg,ub,ub,ub,ux,ux,ux,ur,ur,cr,cb
cb,ux,ur,ur,ur,ur,cr,ux,cr,ur,ur,cg,cb,ub,ub,ub,cr,ux,ux,cr,ur,cr,cb