cr,ur,cr,ub,cb,ub,ub,cb,cb,cb,cg,cg,cg,ur,ur,ur,ux,ux,cr,ux,cb,cb,cb
cg,ur,ur,ur,ur,ur,ur,ur,ur,ur,ur,ur,ur,ur,ux,ur,ux,ux,ur,ur,ur,ur,ur
ur,cr,ur,ur,ur,ur,ux,ur,ur,ur,ur,ur,ur,ur,ur,ur,ur,ur,ur,ur,ur,ur,ur
ur,ur,ur,ur,ur,ur,ur,ur,ub,ub,cr,ur,ub,ur,ur,ur,ur,ur,ur,ur,ur,ur,ur
ur,ur,ur,ur,ur,cr,ur,ur,ub,ux,ub,ur,ub,ur,ur,ur,ux,ux,ux,ux,cr,ur,ur
ux,ux,ur,ur,ur,ur,ur,cr,ub,ux,ub,ur,ub,ux,ux,ux,ux,ux,ux,ux,ux,cb,ux
ux,ux,ux,ux,ur,ur,ur,ur,ub,cb,ur,ur,ub,ux,ux,ux,ux,ux,ux,ux,ux,ub,ux
ux,ux,ux,ux,ur,ux,ux,ux,ux,ux,ux,ux,ub,ux,ux,ux,ux,ux,ux,ux,ux,ub,ux
ur,ur,ur,ur,ux,ux,ux,ub,ub,ub,ub,ub,ub,ub,ub,ux,ug,ug,ug,ug,ub,ub,ux
ur,ux,ux,ur,ux,ux,ub,ub,ux,ub,ub,ub,ub,ub,ub,ux,ug,ub,ub,ub,ub,ux,ux
cr,ux,ux,ur,ux,ug,ub,ub,ub,ub,ub,ub,ub,ub,ub,ux,ug,ug,ug,ug,ub,ux,ux
ux,ux,ux,cg,ux,ug,ux,ux,ug,ub,ub,ub,ub,ub,ub,ux,ug,ug,ux,ug,ub,ug,ux
ux,ux,ux,ug,ux,ug,ux,ux,ux,ux,ux,ux,ux,ug,cb,ub,ub,ub,ux,cg,ux,ug,ux
ux,ux,ux,ug,ux,ug,ux,ux,ux,ux,cb,ug,ug,ug,ux,ub,ux,ux,ux,ug,ug,ug,ux
ux,ux,ux,ug,ur,ug,ux,ux,ug,ug,ug,ug,ug,cg,ug,ug,ug,ux,ux,ux,ux,ux,ux
ux,ux,ug,ug,ur,ug,ux,ux,ux,ux,ug,ug,ug,ug,ux,ub,ug,ug,cg,ux,ux,ux,ux
ux,ug,ug,ug,ug,ug,ux,ux,ux,ux,ug,ug,ug,ug,ux,ub,ux,ug,ug,ux,ux,ux,ux
ux,ug,ug,ug,ug,ug,ur,ur,ur,ux,ug,ug,ux,ux,ux,ub,ux,ug,ug,ux,ux,ux,ux
ux,ux,ux,ur,ug,ug,ux,ux,ux,ux,ug,ug,ub,ub,ub,ub,ux,ux,ux,ux,ux,ux,cb
cg,ux,ux,ur,ug,ug,ux,ub,ub,ub,cb,ub,ub,ux,ux,ux,cr,ur,ur,ur,ur,ur,ur
cb,ux,ur,ur,ur,ur,ur,ub,ub,ub,ub,ub,ur,ur,ur,ur,ur,ur,ur,ur,ur,ur,ur
ux,ux,ur,ux,ur,ub,ub,ub,ub,ub,ub,ux,cg,ux,ux,ux,ux,ux,ux,ux,ux,cr,cb
cb,ux,ur,ur,ur,ub,cr,cb,cr,ub,ub,cg,cb,ux,ux,ux,ux,ux,ux,cr,ux,cr,cb