ug,ug,cr,cg,ug,ur,ur,cb,cb,cb,ur,cg,cg,ur,ur,ur,ur,ur,ur,ux,cb,cb,cb
ug,ug,ug,ug,ug,cr,ur,ur,ur,ur,ur,ur,ur,ur,ur,ur,ur,ub,cr,ur,ur,ur,cb
ug,cr,ur,ug,ux,cr,ur,ur,ur,ur,ur,ur,cr,ur,ur,ur,ur,ur,ux,ux,ur,ur,ur
ug,ug,ug,ug,ug,ug,ur,ur,ur,ug,ug,ug,ug,cg,cr,ur,ur,ur,ux,ur,ur,ur,ur
ux,ux,ur,ug,ug,ux,ur,ur,ux,ug,ux,ux,ux,ux,ub,ux,cg,ux,ux,ux,ux,ux,ur
cb,ux,ur,ug,ug,ux,ug,ur,ug,ug,ux,ug,ug,ug,ub,ub,ug,ub,ux,ux,ux,ux,ur
ux,ux,ur,ug,ug,ux,ux,ur,ur,ur,ur,ug,ug,ug,ub,ug,ug,ub,ux,ux,ux,ux,ur
ux,ug,ug,ug,ur,ur,ug,ux,ux,ux,ux,ux,ux,ux,ub,ub,ub,ub,ux,ux,ux,ux,ur
ux,ug,ux,ug,ur,ur,ug,ux,ux,ux,ux,ux,ux,ux,cb,ub,ux,ub,ux,ux,ux,ux,ur
ux,ug,ur,ug,ux,ux,ux,ux,ux,ux,ux,ux,ux,ux,cr,ur,ur,ur,ur,ub,ux,ux,ur
ux,ug,ug,ug,ux,ux,ux,ux,ux,ux,ux,cb,ux,ux,ub,ux,ux,ub,ur,ub,ux,ux,ur
ux,ux,ux,ug,ux,ux,ux,ux,ux,ux,cg,ub,ux,ub,ub,cb,ux,ub,ur,ub,ux,ux,ur
cb,ux,ux,ug,ux,ux,ux,ux,ux,ux,ug,ub,ub,ub,ub,ub,ub,ub,ur,ub,ux,ux,ur
ub,ub,ub,ub,ux,ux,ux,ux,ux,ux,ug,ux,ub,ub,ub,ub,ub,ub,ur,ux,ux,ux,ur
ux,ub,ub,ub,ub,ux,ux,ug,ug,ug,ug,ur,ub,ub,ux,ux,ux,ux,ur,ux,ux,ux,ur
ux,ub,ub,ub,ub,ux,ux,ug,ug,ug,ug,ur,ux,ub,ub,ub,ur,ux,ur,ux,ux,ub,ub
ux,ub,ux,ux,ur,ur,ur,ur,ug,ug,ug,ux,ux,ur,ur,ur,ur,ur,ur,ub,ub,ub,ub
ux,ux,ux,ux,ur,ur,ux,ur,ug,ug,ux,ux,ux,ux,ux,ur,ur,ur,ug,ub,ub,ub,ur
ux,ux,ux,ux,ur,ur,ux,ug,ug,ug,ux,ux,ux,ux,ug,ug,cg,ub,ug,ub,ub,ub,ur
cg,ux,ux,ux,ux,ux,ux,ug,ug,ug,ux,ux,ux,ux,ug,ug,ug,ug,ug,ug,ub,ux,ur
cb,ux,ux,ux,ux,ux,ux,ux,ux,ux,ux,ux,ux,ux,ux,ux,ux,ug,ux,ur,ub,ur,ur
ux,ux,ux,ux,ux,ux,ux,ux,ux,ux,ux,ux,cg,ux,ur,ux,ux,ux,ur,ur,cb,cr,cb
cb,ux,cg,ux,ux,ux,cr,cb,cr,ux,ux,cg,cb,ux,ur,ur,ur,ur,ur,cr,ur,cr,cb