ur,ur,cr,ur,ur,ur,cb,cb,cb,cb,ur,cg,cg,ur,ur,ur,ur,ur,ur,ur,cb,cb,cb
ur,ur,ur,ur,ur,ur,ur,ur,ur,ur,ur,ur,ur,ur,ur,ur,ur,ur,ur,ur,ur,ur,ur
ur,cr,cb,ur,ur,ur,ur,ur,ur,ur,ur,ur,ur,ur,ur,ur,ur,ur,ur,ur,ur,ur,ur
ur,ur,ur,ur,ur,ur,ur,ur,ur,ur,ur,ur,ur,ur,ur,ur,ur,ur,ur,ur,ur,ur,ur
ug,ur,ur,ub,ub,ur,ur,ur,ur,ur,ur,ur,ur,ur,ur,ur,ur,ur,ur,ur,ur,ur,ur
cg,ur,ub,ub,ub,ub,ur,ub,cr,ur,ur,ur,ur,ur,ur,ur,ur,ur,ur,ur,ur,ur,ur
cg,ur,ub,ub,ub,cb,ub,cb,cr,ur,ur,ur,ur,ur,ur,ur,ur,ur,ur,ur,ug,cr,ug
ug,ug,ub,ub,ub,ub,ub,ub,ub,ur,ur,ur,cr,ub,ub,ub,ub,ub,ub,ub,ub,ub,cb
ug,ug,ug,ub,ur,ub,ur,ur,cg,ur,ur,ur,ur,ur,ur,ug,ur,ur,ur,ur,ug,ug,ug
ug,ug,ug,ub,ub,ub,ur,ur,ur,ur,ur,ur,ur,ur,ur,ur,ur,ur,ur,ur,ur,ug,ug
ug,ug,ug,ug,ub,ub,ur,ur,ug,ur,ur,ur,ur,ur,ur,ur,ur,ur,ur,ur,ur,ug,ug
ug,ug,ug,ug,ur,ur,ur,ug,ug,ur,ur,ur,ur,ur,ur,ur,ug,ur,ur,ur,ur,ug,ug
ug,ug,ub,ug,ur,ur,ur,ur,ur,ur,ur,ur,ur,ur,ur,ur,ur,ur,ur,ur,ur,ug,ug
ug,ug,ur,cg,ur,ur,ur,ur,ur,ur,ur,ur,ur,ug,ug,ur,ur,ur,ur,ur,ur,ug,ug
cg,ug,ur,ur,ur,ur,ur,ur,ur,ur,ur,ub,ub,ug,ug,ur,ug,ug,ug,ug,ug,ug,cg
cb,ug,ur,ur,ur,ur,ub,ur,ur,ur,ur,ug,ub,ug,ug,ur,ug,ur,ur,ur,ur,ur,ub
ur,ur,ur,ur,ur,ur,ur,ur,ur,ur,ur,ug,ub,ub,ub,ur,ub,ur,ur,ur,ur,ur,ub
ur,ug,ug,ur,ur,ur,ur,ur,ur,ur,ur,ub,ur,ur,ub,ub,ub,ur,ur,ur,ur,ur,ub
ur,ur,ur,ur,ur,ug,ur,ug,ur,ur,ur,ub,ur,ur,ub,ub,ub,ur,ur,ur,ur,ur,ub
ug,cr,ug,ur,ur,ug,ur,ug,ug,ug,ur,ub,ub,ur,ub,ub,ub,ur,ur,ur,ur,ur,ub
cb,cb,ug,ur,ur,ur,ur,ur,ur,ur,ur,ur,ur,ur,ur,ub,ur,ur,ur,ur,cb,ub,ub
ug,ur,ur,ur,ur,ug,ub,ur,ur,ur,ur,ur,cg,ur,ur,ur,ur,ur,ur,ur,ur,cr,cb
cb,ur,ur,ur,ur,ug,cr,cr,cr,ur,ur,cg,cb,ur,ur,ur,ur,ur,ur,cr,ur,cr,cb