ur,ur,cr,ur,ur,ur,cg,cb,cb,cb,ux,cg,cg,ux,ux,ur,ur,ur,ur,ur,cb,cb,cb
ur,ur,ur,ur,ur,ur,cr,ug,ug,ug,ug,ux,cb,ux,ux,ux,ur,ur,ur,ur,ur,ur,ur
ur,cr,ur,ur,ur,ur,ug,ur,ur,ur,ug,ux,ux,ux,ux,ux,ur,ur,ur,ur,ur,ur,ur
ur,ur,ur,ur,ur,ur,ug,ur,ux,ux,ug,ur,cg,ux,ux,ux,ur,ur,ur,ur,ur,ur,ur
ur,ur,ux,ux,ux,ux,ug,ur,ux,ux,ug,ur,ug,ur,ug,ug,ug,cg,ur,ur,ur,ur,cr
ur,ur,ur,ur,ur,ur,ug,ur,ux,ux,ug,ur,ug,ur,ug,ug,ur,ur,ux,ux,ub,cb,ug
ur,ur,ur,ur,ur,ur,ur,ur,ur,ux,ug,ux,ug,ur,cr,ur,ur,ur,ug,ug,ub,ug,ug
ur,cr,ur,ub,cb,ub,ug,ux,ur,ux,cb,ux,ug,ux,ur,ur,ur,ux,ux,ux,ub,ux,ux
ur,ur,ur,ur,ur,ur,ur,ur,cb,ux,ub,ub,ug,ur,ug,ug,ug,ub,ub,ub,ub,ux,ux
ur,ur,ur,ur,ur,ur,ur,ub,ub,ub,ub,ur,ug,ur,ug,ug,ug,ug,ug,ub,ux,ux,ux
ur,ur,ur,cr,ux,ux,ug,ub,ub,ub,ug,ug,ug,ur,ug,ux,ux,ux,ux,ub,ux,ux,ux
cr,ur,ux,ux,ux,ux,ug,ux,ub,ub,ug,ug,ux,ub,ug,ux,ux,ub,ug,ub,ug,ux,ux
ux,ur,ux,ux,ux,ux,ug,ub,ub,ub,ug,ug,ub,ub,ug,ux,ux,ub,ug,ub,ug,ux,ux
ux,ur,ux,ux,ux,ux,ux,ub,ub,ub,ug,ug,ug,ug,ug,ux,ux,ub,ug,ub,ug,ux,ux
ux,ur,ug,ux,ux,ux,ux,ub,ub,ub,ug,ub,ub,ub,ux,ux,ux,ub,ub,ub,ub,ux,ux
ux,ur,ub,ub,ub,ux,ux,ux,ub,ub,ug,ub,ub,ub,ux,ux,ux,ux,ux,ub,ub,ux,ux
ur,ur,ub,cb,ub,ub,ux,ux,ux,ub,ug,ub,ub,ux,ux,ux,ux,ub,ub,ub,ub,ux,ux
ur,ur,ur,ur,ur,ur,ur,ur,cr,ur,cg,ux,ux,ux,ux,ux,ux,ux,ux,ux,ux,ux,cg
ur,ux,ur,ug,ug,ug,ur,ur,ur,ur,ux,ux,ux,ux,ux,ux,ux,ux,ux,ux,ux,ux,cb
cg,cg,ux,ug,ux,ux,ux,ux,ux,ux,ux,ux,ux,ux,ux,ux,ux,ux,ux,ux,ux,ux,ux
cb,ug,ug,ug,ux,ux,ux,ux,ux,ux,ux,ux,ux,ux,ux,ux,ux,ux,ux,ux,ux,ux,ux
ux,ux,ux,ux,ux,ux,ux,ux,ux,ux,ux,ux,cg,ux,ux,ux,ux,ux,ux,ux,ux,cr,cb
cb,ux,ux,ux,ux,ux,cr,cb,cr,ux,ux,cg,cb,cb,ux,ux,ux,ux,ux,cr,ux,cr,cb