ur,ur,cr,ur,cr,ur,ur,cb,cb,cb,cg,cr,cg,ux,ur,ur,ur,ur,ug,cb,cb,ux,cb
ur,ur,ug,ur,ug,ur,ur,ur,ur,ur,ur,ur,ur,ur,ur,ug,ux,ur,ug,ux,ux,ux,ux
ur,cr,ug,cg,ug,ur,ur,ur,ur,ur,ur,ur,ur,ur,ur,ur,ur,ur,ug,ux,ux,ux,ux
cg,ur,ug,ur,ur,ur,ur,ur,ur,ur,ur,ur,ux,ux,cb,ub,ur,ur,ug,ux,ux,ux,ux
cb,cg,ug,ur,ur,ur,ur,ur,ur,ur,ur,ur,ur,ur,ux,ub,ur,ur,ug,ux,ux,ux,ux
ur,ur,ur,ur,ur,ur,ur,ux,ur,ur,ur,ur,ub,ub,ub,ub,ur,ur,ug,ux,ux,ux,ux
cr,ur,ur,ug,ur,ur,ur,ur,ur,ur,ur,ur,ub,ur,ur,ux,ux,cg,ug,ux,ux,ux,ux
ur,ur,ur,ub,ur,ur,ur,ur,ur,ug,ug,ub,ub,ux,ur,ux,ux,ug,ug,ux,ux,ux,ux
ur,ur,ub,ub,ub,ub,ur,ub,ur,ub,ug,ub,ub,ur,ur,ux,ug,ug,ug,ug,ug,ug,ux
ur,ur,ub,ub,ur,ub,ur,ub,ub,cb,cr,ug,ub,ub,ub,ug,ug,ug,ug,ug,ug,ug,ug
cr,ub,ub,ub,ub,ub,ux,ug,ub,ug,ur,ug,ub,ub,ub,ug,ug,ug,ux,ug,ug,ug,ug
cg,ub,ub,ub,ux,ur,ur,ur,ub,ur,ur,ug,ug,ub,ub,ub,ug,ug,ug,ug,ug,ug,ug
ux,cb,ux,ux,ux,ur,ur,ug,ub,ub,ur,ub,ug,ug,ub,ub,ug,ug,ug,ug,ug,ug,ug
ux,ux,ux,ux,ux,ur,ur,ug,ux,ur,ur,cg,ug,ug,ug,ug,ur,ur,ur,ur,ur,ur,ur
ux,ux,ux,ux,ux,ur,ur,ur,ur,ur,ub,ug,ug,ug,ub,ug,ug,ug,ug,ux,ub,ub,ub
ux,ux,ux,ub,ub,ur,ur,ug,cr,ur,ub,ub,ug,ug,ug,ug,ux,ub,ub,ub,cb,ub,ub
ux,ux,ux,ub,ub,ub,ux,ub,ug,ur,ub,ub,ub,ub,ug,ug,ux,ux,ub,ux,ub,ub,ur
ux,ux,ux,ub,ux,ub,ux,ub,ub,ub,ub,ux,ux,ux,ux,ug,ux,ux,ub,ub,ub,ur,ur
ux,ub,ub,ub,ux,ub,ux,ub,ug,ur,ub,cb,ux,ux,ux,ug,ux,ux,ub,ub,ub,ub,cb
cg,ub,ub,ub,ux,ub,ux,ub,ug,ur,ug,ub,ug,ug,ug,ug,ux,ux,ux,ux,ub,ub,ux
cb,ub,ub,ub,ux,ub,ux,ub,ur,ur,ub,ub,ux,ux,ux,ux,ux,ux,ux,ux,ux,ux,ux
ur,ub,ub,ub,ub,ub,ub,ub,ur,ur,ub,ub,cg,ux,ux,ux,ux,ux,ux,ux,ux,cr,ux
cb,ub,ub,ub,ub,ur,cr,ur,cr,ur,ur,cg,cb,ux,ux,ux,cr,ux,ux,cr,ux,cr,cb