ug,ug,ug,ug,ug,ug,ur,cb,cb,cb,ub,cg,cg,cb,ug,ug,ug,ug,ug,ug,cb,cb,cb
ug,ug,ug,ug,ug,ug,ug,ug,ug,ug,ub,ug,cb,ug,ug,ur,ug,ug,ug,cg,ub,ub,cg
ug,ug,ug,ug,ug,ug,ur,ug,ug,ug,ub,ug,ub,ug,ug,ug,ug,ug,ug,ug,ug,ug,ug
ug,ug,ux,ug,ug,ug,ur,ug,ug,ug,ub,ub,ub,ur,ur,ub,ug,ug,ug,ug,ug,ug,ug
ug,ug,ug,ug,ug,ug,ug,ug,ug,ug,ug,ug,ug,ug,ug,ug,ug,ug,ur,ug,ug,ug,ug
ug,ug,ug,ug,ug,ug,ug,ug,ug,ug,ug,ug,ug,ug,ug,ug,ug,ug,ug,ug,ug,ug,ug
ug,ug,ug,ug,ug,ur,ur,ur,ug,ug,ug,ug,ug,ug,ug,ug,ug,ug,ur,ur,ub,ug,ug
cg,ug,ug,ur,ug,ug,ur,ug,ug,ug,ub,ur,ur,ur,ur,ug,ug,ur,ub,ur,ug,ug,ug
ur,ug,ug,ur,ug,ug,ur,ug,ug,ug,ug,ug,ug,cg,ug,ug,ug,ug,ug,ug,ur,ug,ur
ur,ug,ug,ur,ug,ug,ur,ug,ug,ug,ug,ug,ug,ug,ug,ug,ug,ug,ug,ur,ur,ug,ur
ur,ug,ug,ur,ur,ur,ur,ur,ug,ug,ug,ur,ur,ug,ug,ug,ug,ug,ug,ur,ur,ug,ur
ur,ur,ur,ur,ur,ur,ur,ur,ur,ur,ug,ur,ug,ug,ug,ug,ug,ug,ug,ur,ug,ug,ur
ur,ur,ur,ur,ur,ur,ur,ur,ur,ur,ug,ur,ug,ug,ur,ug,ug,ug,ur,ur,cb,ug,ur
ur,ur,ur,ur,ug,ur,ur,ug,ug,ug,ug,ur,ur,ur,ur,ur,ur,ur,ub,ub,ub,ur,ur
ur,ur,cr,ur,ug,ur,ur,ub,ug,ur,ug,ur,ur,ug,ug,ug,ug,ub,ub,ub,ub,ug,ur
ur,ur,ub,ur,ub,ur,ur,ub,cg,ub,ug,ug,ur,ug,ug,ug,ug,ub,ub,ub,ub,ug,ur
ur,ur,ur,ur,ur,ur,ur,ur,ug,ur,ub,ug,ur,ur,ub,ug,ug,ub,ub,ub,ub,ub,ur
ur,ug,ug,ur,ur,ur,ur,ur,ug,ug,ug,ug,ur,ug,ug,ug,ub,ub,ub,ub,ub,ub,ur
ur,ug,ug,ug,ug,ur,ur,ug,ur,ug,ub,ug,ur,ub,ug,ug,ub,ub,ub,ub,ub,cb,ur
cr,ug,ug,ur,ur,ur,ur,ur,ur,ur,ub,ur,ur,ug,ug,ug,ur,ub,ub,ub,ub,ur,ur
cb,ug,ug,ur,ur,ur,ur,ur,ur,ug,ur,ur,ur,ur,ur,ur,ur,cr,ub,ub,ub,ur,ur
ug,ug,cg,ug,ur,ur,ur,ur,ug,ug,ur,ur,cg,ug,ur,ur,ug,ug,ub,ub,cb,cr,cb
cb,ug,cr,ur,ur,ur,ur,ug,ug,ug,ur,cg,cb,ug,ug,ug,ug,cb,ug,cr,ub,cr,cb