cr,ur,cr,ug,ug,ug,ur,cb,cb,cb,ur,cg,cg,ur,ur,ur,ub,ur,ur,ur,cb,cb,cb
cg,ur,ub,ub,ug,ug,ub,ub,ur,ur,ur,ur,ur,ur,ur,ur,ur,ur,ur,ur,ur,ur,ur
ug,cr,ug,ug,ug,ug,ug,ug,ur,ur,ur,ur,ur,ur,ur,ur,ur,ur,ur,ur,ur,ub,cr
ug,ug,ug,ug,ug,ug,ug,ub,ur,ur,ur,ur,ur,ur,ur,ur,ur,ur,ur,ur,ur,ub,ub
ug,ug,ug,ug,ug,ug,ug,ub,ur,ub,ub,ur,ur,ur,ur,ur,ur,ur,ur,ur,ub,ub,ub
ug,ug,ug,ug,ug,ug,ug,ug,ur,ub,ub,ub,ub,ur,ub,ub,ub,ub,ub,ub,ub,ub,ub
cg,ug,ug,ug,ug,ug,ug,ug,ur,ug,ub,ub,ub,ur,ur,ur,ur,ur,ur,ur,ub,ub,ub
ub,ug,ug,ug,ug,ug,ug,ug,ur,ub,ub,ub,ub,ur,ub,ub,ub,ub,ug,ur,ur,ur,ub
ug,ug,ug,ug,ug,ur,ur,ub,ub,ub,ub,ub,ub,ur,ug,ug,ur,ur,ur,ur,ub,ur,ub
ug,ug,ug,ug,ug,ub,ub,ub,ub,ub,ub,ub,ub,ur,ug,ug,ub,ub,ub,ur,ub,ur,ub
ug,ug,cr,ug,ug,ug,ug,ug,cb,ur,ub,ub,ub,cb,ug,ug,ug,ur,ur,ur,ur,ur,ub
ug,ug,ur,ur,ug,ur,ur,ur,ur,ug,ub,ub,ub,ub,ug,ug,ub,ur,ub,ur,ub,ur,ub
ug,ub,ur,ug,ug,ur,cb,ur,ur,ur,ub,ub,ub,ub,ub,ug,ug,ur,ug,ur,ub,ub,ub
ug,ug,ur,ub,ug,ub,ub,ub,ub,ur,ub,cg,ug,ug,ug,ug,ug,ur,ub,ur,ur,ur,ub
cg,ug,ur,ug,ug,ub,ur,ur,ur,ur,ug,ug,ug,ug,ug,ug,ur,ur,ug,ur,ub,ub,ub
ub,cb,ur,ub,ug,ur,ur,ur,ur,ur,ug,ug,ug,ug,ug,ug,ug,ug,ug,ur,ub,ub,ub
ub,ug,ur,ug,ug,ur,ur,ur,ur,ur,ur,ug,ub,ur,ub,ub,ur,ub,ug,ur,ur,ur,ub
ub,ug,ur,ug,ug,ug,ug,ur,ur,ur,ug,ug,ub,ur,ub,ug,ug,ug,ug,ur,ur,ur,ub
ub,ug,ur,ub,ug,ug,ug,ug,ub,cr,ug,ug,ug,ug,cg,ub,ub,ub,ur,ur,ur,ur,ub
ub,ub,ub,ub,ug,ug,cg,ub,ub,ub,ub,ug,ub,ub,ub,ub,ub,ub,ub,ur,ub,ub,ub
cb,cb,ub,ub,ub,ub,ub,ub,ub,ub,ub,ug,ub,ub,ub,ub,cb,ug,ur,ur,ur,ur,ug
ug,ug,ug,ug,ug,ug,ug,ug,ug,ug,ug,ug,cg,ub,ub,ub,ub,ug,ur,ur,ur,cr,cb
cb,ug,ug,ug,ur,ur,cr,ug,cr,ub,ub,cg,cb,ub,ub,ub,ur,ur,ur,cr,ub,cr,cb