cr,ur,cr,ub,ub,cr,cb,cb,cb,cb,cg,cg,cg,cr,ur,ur,ur,ur,ur,ur,cb,cb,cb
cg,ug,ug,ur,ug,ur,ug,ug,ug,ug,cb,ub,ub,cr,ur,ur,ur,ur,ub,ur,ur,ur,ur
ur,cr,ur,ur,ux,ur,cr,ux,ux,ux,ux,ux,ux,ux,ux,ub,ur,ub,ub,ur,ur,ur,ur
ur,ur,ur,ur,ur,ur,ur,ur,ux,ux,ux,ur,ur,ur,ur,ur,ur,ux,cr,ur,ur,ur,ur
ur,ur,ur,ur,ur,ur,ur,ur,ur,ur,ux,ur,ux,ub,ux,ub,ub,ux,ux,ur,ur,ur,ur
ur,ur,ur,ur,ur,ur,ur,ur,ur,ur,ur,ur,ux,ub,ub,ub,ub,ux,ux,ur,ur,ur,ur
ur,ur,ux,ux,ug,ug,ug,ug,ug,ug,ug,ug,ug,ug,ug,ug,ug,cr,ur,ur,ur,ur,ur
ux,ux,ux,ux,ug,ug,ug,ug,cg,ux,ux,ux,ub,ub,ub,ub,ub,ug,ux,ux,ux,ux,ur
ux,ux,ux,ux,ux,ux,ux,ux,ux,ux,ux,ub,cb,ub,ub,ug,ug,ug,ux,ux,ux,ux,ur
ux,ux,ux,ux,ux,ux,ux,ux,ux,ub,ub,ub,ub,ug,ug,ug,ub,ug,ux,ux,ux,ux,ur
ux,ux,ug,ug,ug,ug,ug,ux,ug,ug,cb,ub,ub,ug,ub,ub,cg,ug,ux,ux,ux,ux,ur
ux,ux,ug,ux,ug,ug,ug,ug,ug,ub,ub,ub,ub,ub,ub,ug,ug,ug,ux,ux,ux,ux,ur
ux,ux,ug,ux,cg,ug,ug,ug,ux,ug,ub,ub,ub,ub,ub,ug,ux,ux,ux,ux,ux,ux,cg
ux,ux,ux,ux,ux,ux,ug,ug,ux,ug,cb,ux,ux,ux,ux,ug,ug,ug,ug,ug,ux,ux,ug
ux,ux,ux,ux,ux,ux,ug,ug,ux,ug,ux,ux,ug,ug,ug,ug,ug,ug,ug,ug,ux,ux,ug
ux,ux,ux,ux,ux,ux,ux,ux,ux,ug,ux,ux,ug,ub,ub,ux,ux,ux,ux,ux,ux,ux,ug
ux,ux,ux,ux,ux,ux,ux,ur,ur,ug,ug,ug,ug,ug,ug,ur,ur,ur,ur,ur,ur,ur,ug
ux,ux,ux,ux,ux,ux,ux,ux,ur,ur,ur,ur,ur,ur,ug,ug,ug,ug,ug,ug,ug,ug,ug
ux,ux,ux,ux,ux,ux,ux,ux,cr,ur,ur,ur,ur,ur,ur,ur,ur,ur,ur,ub,ub,ub,cb
cg,ux,ux,ux,ux,ux,ux,ux,ux,ux,ux,ux,ub,ub,ux,ub,ux,ub,ub,ub,ub,ub,ub
cb,ux,ux,ux,ux,ux,ux,ux,ux,ux,ux,ux,ux,ub,ux,ub,ux,ub,ub,ub,cb,ub,ub
ux,ux,ux,ux,ux,ux,ux,ux,ux,ux,ux,ux,cg,ub,ux,ub,ub,ub,ux,cb,ub,cr,cb
cb,ux,ux,ux,ux,ux,cr,cb,cr,ux,ux,cg,cb,ux,ux,ux,ux,ux,ux,cr,ub,cr,cb