ur,ur,cr,ur,ur,ur,ur,cb,cb,cb,cg,cg,cg,ux,ux,ub,ur,ur,ur,ur,cb,cb,cb
ur,ur,ur,cr,cg,ur,ur,ug,ux,ux,ux,ux,ux,ub,ub,ub,ur,ub,ur,ur,ur,ur,ur
ur,cr,ur,ur,ug,cr,ug,ug,ur,ur,ur,ur,ur,ub,ub,cb,ur,ur,ur,ur,ur,ur,ur
cb,ur,ur,ug,cg,ur,ug,ug,ur,ur,ur,ur,ur,ur,ur,ur,ur,ur,ur,ur,ur,ur,ur
ur,ur,ur,ur,cr,ur,ur,ug,ur,ur,ur,ur,ur,ur,ur,ur,ur,ux,ux,ur,ur,ub,cr
ur,ur,ur,ur,ur,ur,ur,ug,ux,ux,ur,ur,ur,ur,ur,ur,ur,ur,ur,ub,ub,ub,ub
ur,ur,ur,ur,ur,ur,cb,ug,ur,ur,ur,ur,ur,ur,ur,ur,ur,ur,ur,ub,ur,ur,ub
ur,ur,ur,ur,ur,ub,ub,ug,ug,ug,ur,ug,ug,ur,ur,ur,ur,ur,ur,ub,ub,ub,ub
ur,ur,ur,ur,ur,ub,ub,ur,ug,ug,ur,ur,ur,ur,ur,ur,ur,ub,ub,ub,ub,ub,ub
ur,ur,ur,ur,ur,ur,ub,ur,ug,cg,ur,ug,ur,ur,ur,ur,ur,ub,ub,ub,ux,ux,ub
ur,ur,ur,ur,ur,ur,ur,ur,ur,ur,ug,ug,cr,ub,ur,ug,ug,ug,ug,ug,ub,ub,ub
ur,cr,ux,ur,ur,ur,ur,cg,ug,ug,ug,ug,ub,ub,ug,ug,ug,ug,ug,ug,ub,ug,ux
ur,ur,ur,ur,ur,ur,cr,ur,ur,ur,ur,ur,ur,ux,ug,ur,ug,ug,ug,ug,ub,ug,ux
ur,ur,ur,ur,ur,ur,ug,ur,ur,ur,cb,ux,ur,ur,ug,ug,ug,ug,ug,ug,ub,ug,ux
ur,ur,ur,ur,ur,ur,ur,ur,ur,ur,ur,ur,ur,ur,ur,ur,ug,ug,ug,ug,cg,ux,ux
ux,ux,ux,ux,ux,ur,ur,ur,ux,ug,ug,ug,ug,ug,ug,ug,ug,ug,ux,ux,ug,ux,ux
ux,ur,ur,ur,ur,ur,ur,ur,ur,ur,ux,ug,ur,ur,ur,ur,ur,ur,ur,ur,ub,ur,ur
ux,ur,ur,ur,ur,ur,ur,ur,ur,ur,ur,ur,ur,ur,ub,ub,ur,ur,ur,ur,cb,ur,ux
ux,ux,ux,ub,ub,ub,ub,ub,ub,ur,ug,ug,ur,ub,ub,ub,ub,ub,ub,ub,ub,ux,cb
cg,ux,ux,ux,ub,ub,ub,ub,ub,ub,ug,ug,ug,cb,ux,ux,ux,ux,ux,ux,ub,ux,ux
cb,ux,ux,ux,ub,ub,ux,ux,ub,ub,ub,ub,ux,ux,ux,ux,ux,ub,ub,ub,ub,ux,ux
ux,ux,ux,ux,ux,ux,ux,ux,ub,ub,ub,ub,cg,ux,ux,ux,ux,ux,ux,ux,ux,cr,cb
cb,ux,ux,ux,ux,ux,cr,ux,cr,ub,cb,cg,cb,ux,ux,ux,cr,ux,ux,cr,ux,cr,cb