ur,ux,cr,ur,ur,ur,ur,cb,cb,cb,cg,cg,cg,ur,ur,ur,ur,ur,ur,ur,cb,cb,cb
ur,ur,ur,ur,cr,ur,ur,ur,ur,ur,ur,ur,ur,ur,ur,ur,ur,ur,ur,ur,ur,ur,ur
ur,cr,ur,ur,cr,ur,ur,ur,ur,ur,ur,ur,ur,ur,ur,ur,ur,ur,ur,ur,ur,ur,ur
cb,ur,ur,cg,cr,ur,ur,ur,ur,ur,ux,ux,ur,ur,ur,ur,ur,ur,ur,ur,ux,ur,ur
ur,ur,ur,ug,cr,ur,ug,ug,ug,ur,ur,ur,ug,ug,ub,ub,ub,ub,ug,ur,ur,ur,ur
ur,ur,ur,ur,ur,ur,ug,ug,ug,ub,ub,ur,ug,ug,cr,ug,ug,cb,ug,ur,ur,ur,ur
ur,ur,ur,ur,ur,ur,ug,ug,ug,ub,ub,ub,cg,ur,ur,ur,ur,ur,ug,ug,ur,ur,ur
ur,ur,ur,ur,ur,ur,cg,ur,ur,ur,ur,ur,ur,ur,ur,ub,ub,ur,ug,ug,ug,ur,ur
ur,ur,ur,ur,ur,ug,ur,ug,ug,ub,ug,ug,ug,ur,ub,ug,ug,ug,ug,ug,ug,ur,ur
ur,ur,ur,ur,ug,ug,ur,ug,ug,ub,ug,ug,ug,ur,ub,ub,ub,ub,cg,ug,ub,cb,cr
ur,ur,ux,cg,ug,ug,cr,ug,ug,ub,ub,ug,ug,ur,ub,ub,ux,ux,ug,ux,ug,ug,ub
ur,ur,ur,ur,ur,ug,ug,ug,ug,ub,ub,ub,ub,ub,cb,ug,ug,ug,ug,ug,ug,ug,ur
ur,ur,ur,ur,ur,ur,ur,ur,ur,ur,ub,ur,ub,ur,ub,ug,ux,ug,ug,ug,ug,ug,ur
ux,ux,ux,ux,ux,ur,ur,ur,ur,ur,ub,ux,ub,ur,ub,ug,ug,ux,ux,ug,ug,ug,ur
ux,ux,ux,ur,ur,ub,ub,ub,ux,ux,ux,ux,ux,ur,ub,ub,ub,ug,ug,ug,ug,ux,ur
ux,ux,ux,ur,ur,ub,ub,ub,ub,ub,ub,ub,ub,ur,ub,ub,ub,ur,ur,ur,ur,ur,ur
ux,ux,ux,ux,ux,ux,ux,ub,ub,ub,cb,ub,ub,ub,ub,ur,ur,ur,ur,ux,ub,ux,ux
ux,ux,ux,ux,ux,ux,cb,ub,ub,ub,ub,ub,ub,ub,ub,ub,ub,ub,ur,ub,ub,ux,ux
ux,ux,ux,ux,ux,ux,ub,ux,ux,ub,ub,ub,ub,ub,ur,ub,ub,ub,ur,ub,ub,ux,cb
cg,ux,ux,ux,ux,ux,ux,ub,ub,ub,ub,ux,ub,ub,ur,ub,ux,ux,ur,ux,ub,ux,ux
cb,ux,ux,ux,ux,ux,ub,ub,ub,ub,ub,ub,ub,ub,ub,ub,ux,ub,ur,ub,ub,ux,ux
ux,ux,ux,ux,ux,ux,ub,ub,ub,ub,ub,ub,cg,ub,ub,ur,ur,ur,ur,ux,ux,cr,cb
cb,ux,ux,ux,ux,ux,cr,ub,cr,ub,ub,cg,cb,ur,ur,ur,cr,ux,ux,cr,ux,cr,cb