ur,ur,cr,ur,ur,ur,ur,cb,cb,cb,cg,ur,cg,ux,ur,ur,ur,ur,ur,cb,cb,ux,cb
ur,ug,ug,ub,ub,ur,ur,ur,ur,ur,ur,ur,ur,ur,ur,ur,ur,ur,ur,ux,ux,cb,cb
ur,cr,cg,cb,ub,ur,ug,ur,ur,ur,ur,ur,ur,ur,ur,ur,ur,ur,ur,ur,ur,ur,ur
cg,cr,ur,ur,cr,ur,ug,ur,ur,ur,ur,ur,ur,ur,ur,ur,ur,ur,ur,ub,ub,ub,ub
ur,ur,ur,ur,ur,cg,ug,ub,cr,ur,ur,ur,ur,cb,ur,ur,ur,ur,ur,ub,ub,ub,ub
ur,ur,ur,ub,ub,ur,ug,ub,ub,ub,ur,ur,ug,ub,ub,ub,cr,ub,ub,ub,ur,ux,ux
ur,ur,ur,ub,ur,ur,ur,ur,ur,ub,ub,ub,ub,ub,ub,ub,ug,ux,ux,ur,ur,ux,ux
ur,ur,ub,cg,ur,ug,ug,ur,ug,ug,ug,ub,ub,ub,ub,ub,ux,ux,ux,ux,ub,ub,ub
ub,ub,ub,ug,ug,ug,ug,ug,ug,ur,ub,ub,ux,ub,ux,ub,ux,ux,ux,ux,ub,ux,ub
ub,ux,ub,ux,ux,ux,ur,ub,ux,cb,ub,ub,ub,ub,ux,ub,ub,ub,ux,ux,ub,ux,ub
ub,ux,ub,ux,ux,ux,ur,ub,ug,ug,ur,ub,ub,ub,ub,ub,ub,ub,ux,ux,ub,ux,ub
ub,ux,ub,cg,ux,ux,ur,ub,ug,ub,ur,ub,ub,cb,ub,ub,ub,ub,ug,ux,ub,ux,ub
ub,ux,ub,ug,ux,ux,ur,ub,ug,ug,ur,ug,cr,ur,ur,ur,ur,ur,cb,ub,ub,ub,ub
ub,ux,ub,ug,ux,ux,ur,ub,ug,ug,ur,ug,ug,ub,ug,ub,ug,ug,ug,ux,ub,ux,cg
ub,ux,ub,ug,ug,ug,ug,ub,ug,ub,ur,ug,ub,ub,ug,ub,ux,ub,ub,ux,ub,ux,ux
ub,ux,ub,ux,ux,ux,ug,ub,ug,ug,ur,ug,ub,ux,ux,ub,ux,ub,ub,ub,ub,ux,ux
ub,ux,ub,ux,ux,ux,ug,ug,ug,ug,cr,ug,ux,ux,ux,ub,ux,ux,ux,ux,ub,ux,ux
ub,ub,ub,ub,ub,ub,ur,ub,ub,ub,ub,ub,ux,ux,ux,ub,ux,ux,ux,ux,ub,ux,ux
ux,ux,ub,ux,ux,ub,ux,ur,ux,ub,ub,ux,ux,ux,ux,ub,ub,ux,ux,ux,ub,ux,cb
cg,ux,ub,ub,ub,ub,ub,ub,ub,ub,ub,ux,ux,ux,ux,ux,ub,ux,ux,ux,ub,ux,ux
cb,ux,ux,ux,ux,ub,ux,ux,ux,ux,ub,ux,ux,ux,ux,ux,ub,ux,ux,ux,ub,ux,ux
ur,ub,ub,ub,ub,ub,ub,ub,ub,ub,ub,ux,cg,ux,ux,ux,ub,ub,ub,ub,ub,cr,ux
ur,ub,ub,ub,ub,ub,cr,ux,cr,ux,ux,cg,cb,ux,ux,ux,cr,ux,ux,cr,ur,cr,cb