ur,ur,cr,ur,ur,ur,ur,cb,cb,cb,cg,cg,cg,cb,ur,ur,ur,ur,ur,ur,cb,cb,cb
ur,ur,ur,ur,ur,ur,ur,cg,ur,ub,ur,ur,ur,ur,ur,ur,ur,ur,ug,ug,cg,ur,cb
ur,cr,ur,ur,ur,ur,ur,ur,ur,ur,ur,ur,ur,ur,ur,ur,cr,ug,ug,cr,ur,ur,ur
ur,ur,ur,ur,ur,ur,ur,ur,ur,ur,ur,ur,ug,ug,cr,ur,ur,ur,ur,ur,ur,ur,ur
ur,ur,ur,ur,ur,ur,ur,ur,ur,ur,cg,ur,ug,ur,cr,ur,ur,ur,ur,ur,ur,ur,ur
ur,ur,ur,ur,ug,ug,cr,ug,ug,ug,ug,ur,ug,ug,cg,ur,ur,ur,cr,ur,ur,ur,ur
ur,ur,ur,ur,ug,ug,ur,ur,ur,ur,ur,ur,ur,ur,ur,ux,ur,ur,ug,ug,ux,ug,ux
ux,ur,ur,ur,ux,ur,ur,ur,ur,ur,ur,ur,ur,ur,ur,ux,ux,ux,ux,ux,ux,ug,ux
ur,ur,ur,ur,ur,ur,ur,ug,ug,cb,ub,ur,ur,ur,ur,ub,ub,ub,ub,ux,ux,ug,ux
ur,ur,ur,ur,ur,ur,ur,ub,ub,cr,ub,ug,ur,ur,ug,ug,ur,ub,ub,ug,ug,ug,cb
ur,ur,ur,ur,ur,ur,ur,ur,ub,ur,ub,ub,ur,ur,ug,ug,ug,ug,ub,ub,ur,ux,ub
ur,ur,ur,ur,ug,ug,ug,ug,cg,ur,ux,ub,ug,ug,ug,ub,ub,ug,ub,ub,ub,ub,ub
ur,ur,ur,ur,ug,ub,ug,ug,ug,ur,cb,ub,ub,ub,ub,ub,ug,ug,ub,ub,ux,ux,ux
ux,ur,ub,ub,ug,ug,ug,ug,ug,ur,cb,ub,ux,ur,ug,ug,ug,ug,ub,ub,ux,ux,ux
ux,ux,ub,ur,ux,ub,ug,ug,ub,ur,ub,ub,ug,ug,ug,ug,ug,ux,ub,ub,ux,ux,ux
ux,ux,ub,ur,ur,ub,ur,ux,ub,ur,ur,ur,ur,ur,ur,ur,ur,ur,ur,ub,ux,ux,ux
ux,ux,ub,ub,ub,ub,ux,ux,ux,ur,ur,ub,ub,ub,ur,ux,ux,ur,ur,ub,ux,ux,ux
ux,ux,ub,ux,ux,ux,ux,ux,ux,ur,ur,ub,ub,ub,ug,ug,ug,ur,ur,ub,ub,ub,ub
ub,ub,ub,ux,ux,ux,ux,ux,ux,ur,ur,ux,ug,ur,ur,ux,ux,ur,ur,ub,ub,ub,cb
cg,ux,ux,ux,ux,ux,ux,ux,ux,ur,ur,ux,ug,ug,ug,ug,ug,ur,ur,ub,ub,ub,ux
cb,ux,ux,ux,ux,ux,ux,ux,ux,ur,ur,ux,ux,ux,ux,ux,ux,ur,ur,ux,ux,ux,ux
ux,ux,ux,ux,ux,ux,ux,ux,ux,ur,ur,ux,cg,ux,ux,ux,cb,ur,ur,ux,ux,cr,cb
cb,ux,ux,ux,ux,ux,cr,cb,cr,ur,ur,cg,cb,ux,ux,ux,cr,ur,ur,cr,ux,cr,cb