ub,ub,cr,ux,ux,cr,ux,cb,cb,cb,cg,cg,cg,ur,ur,cg,ug,ur,ur,ur,cb,cb,cb
cg,ub,cb,ur,ur,ux,ux,cg,ur,ur,ur,ur,ur,ur,ur,ur,ug,ur,ur,ur,ur,ur,ur
cr,cr,ur,ur,ur,ug,ug,ug,ug,ug,ug,ur,ug,ug,ug,ug,ug,ur,ur,ur,ur,ur,ur
ur,ux,ur,ur,ur,ug,ux,cr,ur,ur,ug,ug,ug,ug,ug,ub,ub,ur,ub,ur,ur,ur,ur
ur,ux,ur,ur,ur,cg,ur,ur,ur,ur,ur,ug,ur,ur,ur,ub,cr,ur,ub,ur,ur,ur,ur
ur,ux,ur,ur,ur,ur,ur,ur,ur,ur,ur,ug,ug,ur,ub,ub,ug,ur,ur,ur,ur,ur,ur
cr,ur,ur,ur,ur,ur,ur,ur,ub,ub,ur,ug,ug,ug,ub,ug,ug,ur,ur,ur,ux,ux,ur
ur,ur,ug,ur,ur,ur,ur,ur,ug,ug,ur,ug,ug,ug,ub,ug,ug,ur,ur,ur,ux,ux,ur
ur,ug,ug,ur,ur,ur,ur,ur,ur,ur,ur,ub,ug,ug,cb,ug,ug,ur,ur,ur,ur,ur,ur
ur,ur,ur,ur,ur,ur,ub,ub,ub,ub,ub,ub,ug,ug,ur,ug,ug,ub,ux,ux,ur,ux,ur
ur,ur,ur,ur,ur,ur,ub,ub,ub,ub,cb,ub,ug,ug,ug,ug,ub,ux,ux,ug,ur,ug,ur
ur,ur,ur,ur,ux,ux,ub,ug,ub,ub,ub,ub,ug,ub,ug,ug,ug,ug,ug,ug,ur,ug,ur
ur,ur,ur,ur,ux,ux,ug,ug,ub,ub,ub,ub,ug,ub,cg,ug,ug,ug,ug,ux,ur,ug,ur
ur,ur,ur,ur,ug,ug,ug,ug,ug,ug,cb,ug,ug,ub,ub,ug,ug,ug,ug,ux,ur,ug,ur
ur,ur,ur,ur,ur,ur,ur,ug,ug,ug,ur,ug,ur,ur,ur,ug,ug,ug,ug,ug,ur,ur,ur
ur,ur,ur,ur,ur,ur,ur,ug,ug,ug,ug,ug,ux,ux,ub,ub,ub,ug,ug,ug,ur,ug,ur
ux,ub,ub,ub,ub,ux,ug,ur,ur,ur,ur,ug,ug,ux,ug,ux,ub,ux,ux,ux,ur,ux,ur
ub,ub,ux,ub,ub,ux,ux,ux,ux,ur,ur,ux,ug,ux,ug,ux,ub,ux,ux,ux,ur,ux,cr
ub,ub,ub,ub,ub,ux,ux,ux,ux,ur,ur,ux,ug,ug,ug,ux,ub,ux,ux,ux,ur,ux,cb
cg,ub,ub,ub,ub,ux,ux,ub,ub,ub,cb,ux,ux,ux,ur,ux,ub,ux,ux,ux,ur,ux,ux
cb,ux,ub,ux,ub,ub,ub,ub,ub,ur,ur,ux,ux,ux,ur,ux,ub,ux,ux,ux,cr,ux,ux
ux,ux,ub,ub,ub,ub,ub,ub,ub,ub,ub,ux,cg,ux,ux,ux,cb,ux,ux,ux,ux,cr,cb
cb,ux,ub,ub,ub,ux,cr,cb,cr,ub,ub,cg,cb,ux,ux,ux,cr,ux,ux,cr,ux,cr,cb