ur,ur,cr,ur,ur,ur,ur,cb,cb,cb,cg,ur,cg,ur,ur,ur,ur,ur,ur,cb,cb,ux,cb
ur,ur,cg,ug,cr,ur,ur,ur,ur,ur,ur,ur,ur,ur,ur,ur,ur,ur,ur,ur,ur,cb,cb
ur,ur,ur,ug,ug,cr,ug,ur,ur,ur,ur,ur,ur,ur,ur,cr,ur,ur,ur,ur,ur,ur,ur
cg,ur,ur,ug,ug,ur,ug,ur,ur,ur,ur,ur,ur,ur,ug,cr,ur,ur,ur,ub,ub,ub,ub
ur,ur,cg,ug,ug,ur,ug,ub,ub,ub,ub,ub,ub,ub,ug,ug,ug,ur,ur,ub,ub,ub,ub
ur,ur,ur,ur,cr,ur,ug,ub,cb,ur,ur,ur,ug,ub,ub,ub,ub,ub,ub,ub,ur,ux,ux
ur,ur,ur,cb,ur,ur,ur,ur,ur,ur,ur,ur,ug,ug,ub,ub,ug,ux,ux,ur,ur,ux,ux
ur,ur,ub,ub,ur,ur,ur,ur,ug,ug,ug,ub,ub,ub,ub,ub,ux,ux,ux,ux,ub,ub,ub
ub,ub,ub,ur,ur,ur,ur,ur,cg,ur,cr,cb,ux,ub,ux,ub,ux,ux,ux,ux,ub,ux,cb
ub,ux,ub,ux,ux,ux,ur,ub,ux,ux,ub,ub,ub,ub,ux,ub,ub,ub,ux,ux,ub,ux,ur
ub,ux,ub,ux,ux,ux,ur,ub,ug,ug,ug,ub,cb,ub,ux,ur,ux,ub,ux,ux,ub,ux,ur
ub,ux,ub,ux,ux,ux,ur,ub,ug,ub,ug,ub,ub,ub,ug,ub,ub,ub,ug,ux,ub,ux,ur
ub,ux,ub,ux,ux,ux,ur,ub,ug,ug,ug,ug,ub,ub,ug,ub,ug,ux,ug,ux,cr,ur,ur
ub,ux,ub,ux,ux,ux,ur,ub,ug,ug,ug,ug,ug,ub,ug,ub,ug,ug,ug,ug,ub,ug,cg
ub,ux,ub,ux,ux,ux,ur,ub,ug,ub,ug,ug,ub,ub,ug,ub,ux,ub,ub,ux,ub,ux,ux
ub,ux,ub,ux,ux,ux,ur,ub,ug,ug,ug,ug,ub,ug,ug,ub,ux,ub,ub,ub,ub,ux,ux
ub,ux,ub,ux,ux,ux,cg,ug,ug,ug,ug,ug,ur,ur,ux,ub,ux,ub,ub,ux,ub,ux,ux
ub,ub,ub,ub,ub,ub,ur,ub,ub,ub,ub,ub,ur,ux,ux,ub,ux,ux,ux,ux,ub,ux,ux
ux,ux,ub,ux,ux,ub,ux,ur,ur,ub,ub,ur,ur,ux,ux,ub,ub,ux,ux,ux,ub,ux,cb
cg,ux,ub,ub,ub,ub,ub,ub,ub,ub,ub,ux,ux,ux,ux,ux,ub,ux,ux,ux,ub,ux,ux
cb,ux,ux,ux,ux,ub,ux,ux,ux,ux,ub,ux,ux,ux,ux,ux,ub,ux,ux,ux,ub,ux,ux
ur,ub,ub,ub,ub,ub,ub,ub,ub,ub,ub,ux,cg,ux,ux,ux,ub,ub,ub,ub,ub,cr,ux
ur,ub,ub,ub,ub,ub,cr,ux,cr,ux,ux,cg,cb,ux,ux,ux,cr,ux,ux,cr,ur,cr,cb