ur,ur,cr,ux,ux,ux,cr,cb,cb,cb,cg,cg,cg,cb,ur,ur,ur,ur,ur,ur,cb,cb,cb
ur,ur,ur,ux,ux,ux,ur,cg,ur,ur,ur,ur,ur,ur,ur,ur,ur,ur,ur,ur,ur,ur,ur
cr,cr,ur,ux,ux,ux,ur,ur,ur,ux,ur,ur,ur,ur,ur,ur,ur,ur,ur,ur,ur,ur,ur
cb,ur,ur,ux,ux,ux,ux,ux,ux,ux,ur,ur,ur,ur,ur,ur,cr,cg,ur,ur,ur,ur,ur
ux,ur,ux,ux,ux,ux,ux,ux,ux,ux,ur,ur,ur,ur,ur,cr,ug,ug,ur,ur,ur,ur,ur
ug,ug,ug,ug,ug,ug,cg,ur,ur,ur,ur,ur,ur,ur,ur,ur,ur,ur,ug,ur,ur,ur,ur
ug,ur,ux,ux,ux,ur,ur,ur,ur,ur,ur,ur,ur,ur,ur,ur,ug,ug,ug,ur,ur,ux,ux
ug,ur,ur,ur,ur,ur,ur,ur,ur,cb,ub,cr,ur,ur,ub,ub,ub,ub,ug,ur,ur,ux,ux
ux,ux,ux,ux,ur,ur,ur,ur,ug,ug,ug,ub,ub,ur,ub,ub,ub,ub,ug,ur,ur,ux,ux
ux,ux,ux,ur,ug,ug,ug,ug,ug,ur,ug,ur,ub,ur,ug,ug,ur,ur,ur,ux,ux,ux,ux
ur,ur,ur,ur,ug,ug,ug,ur,ur,ug,ug,ur,ur,ur,ug,ub,ur,ur,ur,ur,ux,ux,ux
ur,ur,ur,ur,ur,ur,ur,ur,cg,ug,ug,ug,ug,ug,ug,ub,ur,ub,ub,ur,ur,ur,ur
ur,ur,ux,ux,ug,ug,ur,ur,ur,ur,ug,ug,ur,ug,ub,ug,ub,ub,ub,ux,ur,ux,ur
ur,ur,ux,ug,ug,ug,ug,ug,ug,ug,cb,ug,ur,ug,ub,ub,ub,cb,ub,ub,ur,ub,ur
ur,ur,ux,ux,ug,ug,ur,ur,ur,ug,ug,ug,cg,ug,ug,ug,ug,ub,ub,ub,ur,ub,ur
ur,ur,ux,ux,ug,ug,ur,ur,ur,ub,ub,ub,ug,ub,cr,ux,ux,ux,ub,ub,ur,ub,ur
ur,cr,ux,ux,ux,ur,ur,ur,ur,ur,ug,ug,ur,ux,ur,ur,ur,ur,ur,ur,ur,ux,ur
ur,ux,ux,ux,ux,ur,ur,ur,ur,ur,ux,ux,ur,ur,ur,ur,ur,ur,ur,ur,ur,ur,ur
ur,ur,ur,ur,ur,ur,ur,ur,ux,ur,ux,ur,ux,ux,ux,ux,ux,ux,ux,ux,ux,ux,cb
cg,ux,ux,ux,ux,ur,ur,ur,ux,ur,ux,ur,ur,ur,ur,ur,ur,ur,ur,ur,ur,ur,ur
cb,ux,ux,ux,ux,ur,ur,ur,ux,ur,ur,ur,ur,ur,ur,ur,ur,ur,ur,ur,ur,ur,ur
ux,ux,ux,ux,ux,ur,ur,ur,ux,ux,ux,ux,cg,ux,ux,ux,cb,ux,ux,ux,ux,cr,cb
cb,ur,ur,ur,ur,ur,cr,cb,cr,ux,ux,cg,cb,ux,ux,ux,cr,ux,ux,cr,ux,cr,cb